30 100
CAAAAAACACTCCTTTACGGCACGGATCTC|GGCAAAAAACTTGCGGGCCCTGGGCAGGCA
CTCCAGGCACGTGAAGACAGTGGTTGCGGG|AGGTTGACTACGGGTCGCTTGCTAGATTAC
GAAGTCGGAGTGCAAGCGTAAGACCCATCT|AAAAAACACTCGGCCCTGGGCAGGCAAAAA
TAATGCGACTCATGCATCAAATGTGAGATG|ACCGGAGCTCCTTGCGGGCCCTGGGCAGGC
CTTGCACCAACCTGACCTTCTTTCCATGGT|GTCTCAGCATAAGGCGAGTCCCGACGGTGA
GCTGACGGAAGACCACGTAATCGACCTTGC|ACTTAGCAATTCCCTCGCTGGGATTAAAAT
CTGGGCAGGCAAAAAACACTCTCTTATAGG|TGTTGCGGGCCCTGGGCAGGCAAAAAACAC
GGGTCGCTTGCTAGATTACTCTCTCCTCAC|GGCACGGATCTCAGTCACCGGGTTAAAAGA
CCATGGTACGCTTAAAAGGGCACGTATTGC|ACGGTGAGCACCGTTTCCGGACCTCCAGGC
GGCAGGCAAAAAACACTCACCCTTGCGGGC|CCTGGGCAGGCAAAAAACACTCCATACTTA
AGCCACGTACATTGCATTAGTAATGCGACT|CGTTAATAGGAATATGGGCTACCGGAGCTC
CTGGGCAGGCAAAAAACACTCACGAACGCA|AATTAGCGCCACATCCTATTTTTCCACCCA
CTAATGCAGTCCAGGCACCACCTAACTCCG|AATGCGACTCATGCATCAAATGTGAGATGA
AAAACACTCACCCTTGCGGGCCCTGGGCAG|GCAAAAAACACTCCATACTTACAACACCTT
TGCACCATCGTGCTTCCTATTCATGTTTTG|CGTAAACCAGCTGTTGACGTGGACTTGCAC
GAGTGAGAGCCTGGGACAATCCTGACTGTT|GGGCCCTGGGCAGGCAAAAAACACTCACCC
TATTGACTTTTAGGGTTCTAATGCAGTCCA|ACGTACATTGCATTAGTAATGCGACTCATG
GGCCCTGGGCAGGCAAAAAACACTCGAAGC|GGCAAAAAACACTCCCATAGAGTCTATCTT
GGGCTACCGGAGCTCCTTGCGGGCCCTGGG|GTTAGCTCTCCTGTCGGGCATTTAAACTGT
TGCGTAAACCAGCTGTTGACGTGGACTTGC|ACTCGAAGCTGCATGGCGCTAAGCCGTCTC
CGCCCTATTCAGCGGACGAGTTCCCTGGCC|GCCCTGGGCAGGCAAAAAACACTCACGAAC
TTATAGGTTGACTACGGGTCGCTTGCTAGA|AAAACACTCCTTTACGGCACGGATCTCAGT
CTGACTGTTGCGGGCCCTGGGCAGGCAAAA|CACTCACCCTTGCGGGCCCTGGGCAGGCAA
AAAAACACTCGCGCCCTATTCAGCGGACGA|AGGGGTTGCGGGCCCTGGGCAGGCAAAAAA
CGACTCATGCATCAAATGTGAGATGACTCT|AGCTCCTTGCGGGCCCTGGGCAGGCAAAAA
GCCCTGGGCAGGCAAAAAACACTCTGCGGG|CCTGACCTTCTTTCCATGGTACGCTTAAAA
CAGGTTCCGTTAATAGGAATATGGGCTACC|CAGTGGCATTCGGCATACCATAGTTAGCTC
AATGCGACTCATGCATCAAATGTGAGATGA|CCGGAGCTCCTTGCGGGCCCTGGGCAGGCA
CTCTAACGCAAACTTCGTCTACACCACTAC|AAAAACACTCATACTGAACTTAGCGACACT
ACACTCACGAACGCAGGTTCCGTTAATAGG|CTATTTTTCCACCCAGTGGCATTCGGCATA
GGGCAGGCAAAAAACACTCACGAACGCAGG|TTAGCGCCACATCCTATTTTTCCACCCAGT
CCTGGGCAGGCAAAAAACACTCCATACTTA|AAAAACACTCAAAGTTAGCCCCTTTGTAGC
GGCCCTGGGCAGGCAAAAAACACTCATACT|TTAAACTGTATACCGCGTACAGTGTCTGAC
GCATAAGGCGAGTCCCGACGGTGAGCACCG|TACTTGCGGGCCCTGGGCAGGCAAAAAACA
ACCACCTAACTCCGCTATACCATATTGCGG|CAAATGTGAGATGACTCTAACGCAAACTTC
TTTCCATGGTACGCTTAAAAGGGCACGTAT|CCGACGGTGAGCACCGTTTCCGGACCTCCA
ACTCTCTTATAGGTTGACTACGGGTCGCTT|AGGCAAAAAACACTCCTTTACGGCACGGAT
TTGCGGGCCCTGGGCAGGCAAAAAACACTC|CGTGAAGACAGTGGTTGCGGGCCCTGGGCA
CAGGCAAAAAACACTCTGATGTGGTGGAAG|TATTGCGTTGCGGGCCCTGGGCAGGCAAAA
CGGCACGGATCTCAGTCACCGGGTTAAAAG|CCCTGGGCAGGCAAAAAACACTCACTCCGG
CCCTATTCAGCGGACGAGTTCCCTGGCCCA|CCTGGGCAGGCAAAAAACACTCACGAACGC
TCCGGCGAATCCACTTAGCAATTCCCTCGC|TTGACTACACGAACCGGAATCCCTTGCTCG
GCGGGCCCTGGGCAGGCAAAAAACACTCCA|CAGGCAAAAAACACTCAAAGTTAGCCCCTT
AAACACTCCATACTTACAACACCTTGCAGA|TTAGCCCCTTTGTAGCGGCCTGCACACACG
AGCCTGGGACAATCCTGACTGTTGCGGGCC|GGGCAGGCAAAAAACACTCACCCTTGCGGG
GGCGAATCCACTTAGCAATTCCCTCGCTGG|ACTACACGAACCGGAATCCCTTGCTCGTTG
CGGGCCCTGGGCAGGCAAAAAACACTCTGC|CAACCTGACCTTCTTTCCATGGTACGCTTA
CTTCTTTCCATGGTACGCTTAAAAGGGCAC|AGTCCCGACGGTGAGCACCGTTTCCGGACC
ACTCTGATGTGGTGGAAGTCGGAGTGCAAG|GGCCCTGGGCAGGCAAAAAACACTCGGCCC
ATTCATGTTTTGCGGGCCCTGGGCAGGCAA|GTGGACTTGCACCAACCTGACCTTCTTTCC
AATAGGAATATGGGCTACCGGAGCTCCTTG|GGCATACCATAGTTAGCTCTCCTGTCGGGC
CTGCGTAAACCAGCTGTTGACGTGGACTTG|CACTCGAAGCTGCATGGCGCTAAGCCGTCT
ACTCTCTCCTCACACGGTGCGGCATACCTA|CCGGGTTAAAAGAAATTAGGCTGACGGAAG
GGGCAGGCAAAAAACACTCTCTTATAGGTT|TTGCGGGCCCTGGGCAGGCAAAAAACACTC
TATCTTTACTCGAACAACGGTAATGTGGTA|GTCTGCAATCGAGTGAGTGAGAGCCTGGGA
AGGCAAAAAACACTCCCATAGAGTCTATCT|CACACGGTGCGGCATACCTACGAAAGTCTG
CACTCGCGCCCTATTCAGCGGACGAGTTCC|TTGCGGGCCCTGGGCAGGCAAAAAACACTC
GTTGCGGGCCCTGGGCAGGCAAAAAACACT|TAGATTACTCTCTCCTCACACGGTGCGGCA
CCACGTAATCGACCTTGCGGGCCCTGGGCA|CCTCGCTGGGATTAAAATTTGCGGGCCCTG
TGACGGAAGACCACGTAATCGACCTTGCGG|TTAGCAATTCCCTCGCTGGGATTAAAATTT
TTCAGCGGACGAGTTCCCTGGCCCAACCTA|GCAGGCAAAAAACACTCACGAACGCAGGTT
GGCAGGCAAAAAACACTCAAAGTTAGCCCC|TGGGCAGGCAAAAAACACTCGCGCCCTATT
AAACACTCAAAGTTAGCCCCTTTGTAGCGG|AAAAACACTCGCGCCCTATTCAGCGGACGA
TGGGCAGGCAAAAAACACTCTCTTATAGGT|GTTGCGGGCCCTGGGCAGGCAAAAAACACT
CAGCGGACGAGTTCCCTGGCCCAACCTAAA|AGGCAAAAAACACTCACGAACGCAGGTTCC
CCCTGGGCAGGCAAAAAACTTGCGGGCCCT|ACAACACCTTGCAGAACGGGGTCTTGCCTC
AAACTTCGTCTACACCACTACAGGGGTTGC|CATACTGAACTTAGCGACACTGCCCACCAT
GGGCCCTGGGCAGGCAAAAAACACTCACGA|GGATGAATTAGCGCCACATCCTATTTTTCC
CGGACCTCCAGGCACGTGAAGACAGTGGTT|CTTATAGGTTGACTACGGGTCGCTTGCTAG
ACACTCACTCCGGCGAATCCACTTAGCAAT|GACAATCATTGACTACACGAACCGGAATCC
TTGCGGGCCCTGGGCAGGCAAAAAACACTC|TATTGCGGGCCCTGGGCAGGCAAAAAACAC
GGGCAGGCAAAAAACACTCACTCCGGCGAA|CTCCTTGTCTCATGACAATCATTGACTACA
CCATAGAGTCTATCTTTACTCGAACAACGG|ACCTACGAAAGTCTGCAATCGAGTGAGTGA
TCTCCTCACACGGTGCGGCATACCTACGAA|GTTAAAAGAAATTAGGCTGACGGAAGACCA
ATGTGAGATGACTCTAACGCAAACTTCGTC|CTGGGCAGGCAAAAAACACTCATACTGAAC
TTGCACCATCGTGCTTCCTATTCATGTTTT|GCGTAAACCAGCTGTTGACGTGGACTTGCA
GAAGCTGCATGGCGCTAAGCCGTCTCAGCA|ATCTTTACTCGAACAACGGTAATGTGGTAC
TTCTAATGCAGTCCAGGCACCACCTAACTC|GTAATGCGACTCATGCATCAAATGTGAGAT
ACACCTTGCAGAACGGGGTCTTGCCTCCTC|CCTGCACACACGTCAAACTATTGTATTGAC
CCTAAAGCCACGTACATTGCATTAGTAATG|GGTTCCGTTAATAGGAATATGGGCTACCGG
CGGCCCTGGGCAGGCAAAAAACACTCGAAG|AGGCAAAAAACACTCCCATAGAGTCTATCT
CTGACCTTCTTTCCATGGTACGCTTAAAAG|AGGCGAGTCCCGACGGTGAGCACCGTTTCC
AACACTCCTTTACGGCACGGATCTCAGTCA|AAAACTTGCGGGCCCTGGGCAGGCAAAAAA
TCATGTTTTGCGGGCCCTGGGCAGGCAAAA|GGACTTGCACCAACCTGACCTTCTTTCCAT
TCGAACAACGGTAATGTGGTACTTGCGGGC|CGAGTGAGTGAGAGCCTGGGACAATCCTGA
TCCGCTATACCATATTGCGGGCCCTGGGCA|ATGACTCTAACGCAAACTTCGTCTACACCA
GTCTATCTTTACTCGAACAACGGTAATGTG|AAAGTCTGCAATCGAGTGAGTGAGAGCCTG
CTGGGATTAAAATTTGCGGGCCCTGGGCAG|GTTGCGGGCCCTGGGCAGGCAAAAAACACT
GGTACGCTTAAAAGGGCACGTATTGCGTTG|TGAGCACCGTTTCCGGACCTCCAGGCACGT
GCAAAAAACACTCCCATAGAGTCTATCTTT|CACGGTGCGGCATACCTACGAAAGTCTGCA
ATTCAGCGGACGAGTTCCCTGGCCCAACCT|GGCAGGCAAAAAACACTCACGAACGCAGGT
GCAAAAAACACTCTGATGTGGTGGAAGTCG|TGCGTTGCGGGCCCTGGGCAGGCAAAAAAC
CACACGTCAAACTATTGTATTGACTTTTAG|TGGCCCAACCTAAAGCCACGTACATTGCAT
GTACGCTTAAAAGGGCACGTATTGCGTTGC|GAGCACCGTTTCCGGACCTCCAGGCACGTG
CGCAGGTTCCGTTAATAGGAATATGGGCTA|CCCAGTGGCATTCGGCATACCATAGTTAGC
GGGTTGCGGGCCCTGGGCAGGCAAAAAACA|CCACCATGGATGAATTAGCGCCACATCCTA
CTCACGAACGCAGGTTCCGTTAATAGGAAT|TTTTTCCACCCAGTGGCATTCGGCATACCA
GAGTGAGTGAGAGCCTGGGACAATCCTGAC|TTGCGGGCCCTGGGCAGGCAAAAAACACTC
GTGGTGGAAGTCGGAGTGCAAGCGTAAGAC|GCAGGCAAAAAACACTCGGCCCTGGGCAGG
GTAGCGGCCTGCACACACGTCAAACTATTG|CGGACGAGTTCCCTGGCCCAACCTAAAGCC
ACTTGCGGGCCCTGGGCAGGCAAAAAACAC|ACAATCCTGACTGTTGCGGGCCCTGGGCAG
AAAACACTCCTTTACGGCACGGATCTCAGT|AAAAAACTTGCGGGCCCTGGGCAGGCAAAA
GCCTGGGACAATCCTGACTGTTGCGGGCCC|GGCAGGCAAAAAACACTCACCCTTGCGGGC
CTGCTGCGTAAACCAGCTGTTGACGTGGAC|AAACACTCGAAGCTGCATGGCGCTAAGCCG
GGTACTTGCGGGCCCTGGGCAGGCAAAAAA|GGGACAATCCTGACTGTTGCGGGCCCTGGG
TCTCATGACAATCATTGACTACACGAACCG|AGGGTTCTAATGCAGTCCAGGCACCACCTA
TCCATGGTACGCTTAAAAGGGCACGTATTG|GACGGTGAGCACCGTTTCCGGACCTCCAGG
ATTGTATTGACTTTTAGGGTTCTAATGCAG|AGCCACGTACATTGCATTAGTAATGCGACT
GGGCCCTGGGCAGGCAAAAAACACTCGCGC|TCGTCTACACCACTACAGGGGTTGCGGGCC
GCCCTGGGCAGGCAAAAAACACTCAAAGTT|GGGCCCTGGGCAGGCAAAAAACACTCGCGC
AGCGTAAGACCCATCTGCTGCGTAAACCAG|CCTGGGCAGGCAAAAAACACTCGAAGCTGC
GCAATTCCCTCGCTGGGATTAAAATTTGCG|AATCCCTTGCTCGTTGCGGGCCCTGGGCAG
CTTGCACCATCGTGCTTCCTATTCATGTTT|TGCGTAAACCAGCTGTTGACGTGGACTTGC
AAGGGCACGTATTGCGTTGCGGGCCCTGGG|TCCGGACCTCCAGGCACGTGAAGACAGTGG
TACACGAACCGGAATCCCTTGCTCGTTGCG|GGCACCACCTAACTCCGCTATACCATATTG
AAAAACTTGCGGGCCCTGGGCAGGCAAAAA|GAACGGGGTCTTGCCTCCTCCTTGTCTCAT
GATCTCAGTCACCGGGTTAAAAGAAATTAG|CAGGCAAAAAACACTCACTCCGGCGAATCC
TCAGCGGACGAGTTCCCTGGCCCAACCTAA|CAGGCAAAAAACACTCACGAACGCAGGTTC
GCAAAAAACACTCACGAACGCAGGTTCCGT|CCACATCCTATTTTTCCACCCAGTGGCATT
AGTCACCGGGTTAAAAGAAATTAGGCTGAC|AAAAACACTCACTCCGGCGAATCCACTTAG
GCGCCCTATTCAGCGGACGAGTTCCCTGGC|GGCCCTGGGCAGGCAAAAAACACTCACGAA
AACACTCAAAGTTAGCCCCTTTGTAGCGGC|AAAACACTCGCGCCCTATTCAGCGGACGAG
GCCCTGGGCAGGCAAAAAACACTCCCATAG|CTCTCTCCTCACACGGTGCGGCATACCTAC
TAAAAGGGCACGTATTGCGTTGCGGGCCCT|GTTTCCGGACCTCCAGGCACGTGAAGACAG
AAAAAACTTGCGGGCCCTGGGCAGGCAAAA|AGAACGGGGTCTTGCCTCCTCCTTGTCTCA
CTCACTCCGGCGAATCCACTTAGCAATTCC|AATCATTGACTACACGAACCGGAATCCCTT
CCTTGTCTCATGACAATCATTGACTACACG|CTTTTAGGGTTCTAATGCAGTCCAGGCACC
TAAGACCCATCTGCTGCGTAAACCAGCTGT|GGCAGGCAAAAAACACTCGAAGCTGCATGG
GGGGTTGCGGGCCCTGGGCAGGCAAAAAAC|CCCACCATGGATGAATTAGCGCCACATCCT
ATACCATATTGCGGGCCCTGGGCAGGCAAA|CTAACGCAAACTTCGTCTACACCACTACAG
TCCCGACGGTGAGCACCGTTTCCGGACCTC|CTGGGCAGGCAAAAAACACTCTCTTATAGG
GCCCTGGGCAGGCAAAAAACACTCCATACT|CAAAAAACACTCAAAGTTAGCCCCTTTGTA
GACTGTTGCGGGCCCTGGGCAGGCAAAAAA|CTCACCCTTGCGGGCCCTGGGCAGGCAAAA
CATATTGCGGGCCCTGGGCAGGCAAAAAAC|CGCAAACTTCGTCTACACCACTACAGGGGT
GCTGTTGACGTGGACTTGCACCAACCTGAC|CATGGCGCTAAGCCGTCTCAGCATAAGGCG
TGGCGCTAAGCCGTCTCAGCATAAGGCGAG|CGAACAACGGTAATGTGGTACTTGCGGGCC
ACTCCCATAGAGTCTATCTTTACTCGAACA|GCATACCTACGAAAGTCTGCAATCGAGTGA
CAAACTTCGTCTACACCACTACAGGGGTTG|TCATACTGAACTTAGCGACACTGCCCACCA
CGTTGCGGGCCCTGGGCAGGCAAAAAACAC|CACGTGAAGACAGTGGTTGCGGGCCCTGGG
GTTGCGGGCCCTGGGCAGGCAAAAAACACT|ACCATGGATGAATTAGCGCCACATCCTATT
ATCAAATGTGAGATGACTCTAACGCAAACT|GGGCCCTGGGCAGGCAAAAAACACTCATAC
CGTAAACCAGCTGTTGACGTGGACTTGCAC|TCGAAGCTGCATGGCGCTAAGCCGTCTCAG
CTCTTATAGGTTGACTACGGGTCGCTTGCT|CAAAAAACACTCCTTTACGGCACGGATCTC
GAACAACGGTAATGTGGTACTTGCGGGCCC|AGTGAGTGAGAGCCTGGGACAATCCTGACT
GGCTACCGGAGCTCCTTGCGGGCCCTGGGC|TTAGCTCTCCTGTCGGGCATTTAAACTGTA
CTCGCGCCCTATTCAGCGGACGAGTTCCCT|GCGGGCCCTGGGCAGGCAAAAAACACTCAC
CTATTCATGTTTTGCGGGCCCTGGGCAGGC|ACGTGGACTTGCACCAACCTGACCTTCTTT
CTTCGTCTACACCACTACAGGGGTTGCGGG|ACTGAACTTAGCGACACTGCCCACCATGGA
ACTCACGAACGCAGGTTCCGTTAATAGGAA|ATTTTTCCACCCAGTGGCATTCGGCATACC
CAGGCAAAAAACACTCGCGCCCTATTCAGC|CACTACAGGGGTTGCGGGCCCTGGGCAGGC
CTCCGGCGAATCCACTTAGCAATTCCCTCG|ATTGACTACACGAACCGGAATCCCTTGCTC
ACTTCGTCTACACCACTACAGGGGTTGCGG|TACTGAACTTAGCGACACTGCCCACCATGG
GGGCAGGCAAAAAACACTCGCGCCCTATTC|CACCACTACAGGGGTTGCGGGCCCTGGGCA
ACGAACGCAGGTTCCGTTAATAGGAATATG|TTCCACCCAGTGGCATTCGGCATACCATAG
ACTCTGCGGGCCCTGGGCAGGCAAAAAACA|ACGCTTAAAAGGGCACGTATTGCGTTGCGG
AGTGAGAGCCTGGGACAATCCTGACTGTTG|GGCCCTGGGCAGGCAAAAAACACTCACCCT
ATGTGGTACTTGCGGGCCCTGGGCAGGCAA|GCCTGGGACAATCCTGACTGTTGCGGGCCC
GCAAAAAACTTGCGGGCCCTGGGCAGGCAA|GCAGAACGGGGTCTTGCCTCCTCCTTGTCT
TTCATGTTTTGCGGGCCCTGGGCAGGCAAA|TGGACTTGCACCAACCTGACCTTCTTTCCA
AAAAACACTCCTTTACGGCACGGATCTCAG|CAAAAAACTTGCGGGCCCTGGGCAGGCAAA
CCTGGGACAATCCTGACTGTTGCGGGCCCT|GCAGGCAAAAAACACTCACCCTTGCGGGCC
ATTGCGGGCCCTGGGCAGGCAAAAAACACT|AAACTTCGTCTACACCACTACAGGGGTTGC
CAACACCTTGCAGAACGGGGTCTTGCCTCC|GGCCTGCACACACGTCAAACTATTGTATTG
CAGGCAAAAAACACTCTGCGGGCCCTGGGC|TCTTTCCATGGTACGCTTAAAAGGGCACGT
AGCACCGTTTCCGGACCTCCAGGCACGTGA|AAAAACACTCTCTTATAGGTTGACTACGGG
CTACGGGTCGCTTGCTAGATTACTCTCTCC|TTACGGCACGGATCTCAGTCACCGGGTTAA
CTCGAACAACGGTAATGTGGTACTTGCGGG|TCGAGTGAGTGAGAGCCTGGGACAATCCTG
CTGACGGAAGACCACGTAATCGACCTTGCG|CTTAGCAATTCCCTCGCTGGGATTAAAATT
AGACCACGTAATCGACCTTGCGGGCCCTGG|TTCCCTCGCTGGGATTAAAATTTGCGGGCC
GGGCCCTGGGCAGGCAAAAAACACTCAAAG|GCGGGCCCTGGGCAGGCAAAAAACACTCGC
GCGGGCCCTGGGCAGGCAAAAAACACTCGG|TGAAGACAGTGGTTGCGGGCCCTGGGCAGG
CTGGGCAGGCAAAAAACACTCTGCGGGCCC|GACCTTCTTTCCATGGTACGCTTAAAAGGG
AACCAGCTGTTGACGTGGACTTGCACCAAC|AGCTGCATGGCGCTAAGCCGTCTCAGCATA
ATACTTACAACACCTTGCAGAACGGGGTCT|TTGTAGCGGCCTGCACACACGTCAAACTAT
AGCCGTCTCAGCATAAGGCGAGTCCCGACG|GGTAATGTGGTACTTGCGGGCCCTGGGCAG
CGCTGGGATTAAAATTTGCGGGCCCTGGGC|TCGTTGCGGGCCCTGGGCAGGCAAAAAACA
TCGAGTGAGTGAGAGCCTGGGACAATCCTG|CCTTGCGGGCCCTGGGCAGGCAAAAAACAC
AAAAACACTCGAAGCTGCATGGCGCTAAGC|CATAGAGTCTATCTTTACTCGAACAACGGT
TGCGACTCATGCATCAAATGTGAGATGACT|GGAGCTCCTTGCGGGCCCTGGGCAGGCAAA
TGCCTCCTCCTTGTCTCATGACAATCATTG|TGTATTGACTTTTAGGGTTCTAATGCAGTC
GCGGCCTGCACACACGTCAAACTATTGTAT|ACGAGTTCCCTGGCCCAACCTAAAGCCACG
GCAGTCCAGGCACCACCTAACTCCGCTATA|GACTCATGCATCAAATGTGAGATGACTCTA
CCTGGGCAGGCAAAAAACACTCACGAACGC|GAATTAGCGCCACATCCTATTTTTCCACCC
AAAGAAATTAGGCTGACGGAAGACCACGTA|CCGGCGAATCCACTTAGCAATTCCCTCGCT
CTGGGCAGGCAAAAAACTTGCGGGCCCTGG|AACACCTTGCAGAACGGGGTCTTGCCTCCT
CCATCGTGCTTCCTATTCATGTTTTGCGGG|AACCAGCTGTTGACGTGGACTTGCACCAAC
GCAGGCAAAAAACACTCCATACTTACAACA|CACTCAAAGTTAGCCCCTTTGTAGCGGCCT
TTCGTCTACACCACTACAGGGGTTGCGGGC|CTGAACTTAGCGACACTGCCCACCATGGAT
AAATTAGGCTGACGGAAGACCACGTAATCG|CGAATCCACTTAGCAATTCCCTCGCTGGGA
TTGCAGAACGGGGTCTTGCCTCCTCCTTGT|ACACACGTCAAACTATTGTATTGACTTTTA
GGCAAAAAACACTCTGCGGGCCCTGGGCAG|TTTCCATGGTACGCTTAAAAGGGCACGTAT
AAAAAACACTCACGAACGCAGGTTCCGTTA|ACATCCTATTTTTCCACCCAGTGGCATTCG
GCGGGCCCTGGGCAGGCAAAAAACACTCAC|ATGGATGAATTAGCGCCACATCCTATTTTT
TTACGGCACGGATCTCAGTCACCGGGTTAA|GGGCCCTGGGCAGGCAAAAAACACTCACTC
GACTCTAACGCAAACTTCGTCTACACCACT|CAAAAAACACTCATACTGAACTTAGCGACA
GCCCTGGGCAGGCAAAAAACACTCTCTTAT|GACTGTTGCGGGCCCTGGGCAGGCAAAAAA
AGGCAAAAAACTTGCGGGCCCTGGGCAGGC|TTGCAGAACGGGGTCTTGCCTCCTCCTTGT
GGGCCCTGGGCAGGCAAAAAACACTCACCC|TTGCGGGCCCTGGGCAGGCAAAAAACACTC
AACACTCCCATAGAGTCTATCTTTACTCGA|GCGGCATACCTACGAAAGTCTGCAATCGAG
ACTCCATACTTACAACACCTTGCAGAACGG|CCCCTTTGTAGCGGCCTGCACACACGTCAA
CGGAATCCCTTGCTCGTTGCGGGCCCTGGG|TAACTCCGCTATACCATATTGCGGGCCCTG
GTTCTAATGCAGTCCAGGCACCACCTAACT|AGTAATGCGACTCATGCATCAAATGTGAGA
GAGATGACTCTAACGCAAACTTCGTCTACA|GCAGGCAAAAAACACTCATACTGAACTTAG
GGCAAAAAACACTCCCATAGAGTCTATCTT|ACACGGTGCGGCATACCTACGAAAGTCTGC
TGACGTGGACTTGCACCAACCTGACCTTCT|CGCTAAGCCGTCTCAGCATAAGGCGAGTCC
TGCGGGCCCTGGGCAGGCAAAAAACACTCT|ACCAACCTGACCTTCTTTCCATGGTACGCT
TAGCGGCCTGCACACACGTCAAACTATTGT|GGACGAGTTCCCTGGCCCAACCTAAAGCCA
CTGTTGCGGGCCCTGGGCAGGCAAAAAACA|CACCCTTGCGGGCCCTGGGCAGGCAAAAAA
TAAAGCCACGTACATTGCATTAGTAATGCG|TTCCGTTAATAGGAATATGGGCTACCGGAG
GCGCTAAGCCGTCTCAGCATAAGGCGAGTC|AACAACGGTAATGTGGTACTTGCGGGCCCT
AAAAACACTCTGATGTGGTGGAAGTCGGAG|GTTGCGGGCCCTGGGCAGGCAAAAAACACT
ACATTGCATTAGTAATGCGACTCATGCATC|GGAATATGGGCTACCGGAGCTCCTTGCGGG
CTCATGACAATCATTGACTACACGAACCGG|GGGTTCTAATGCAGTCCAGGCACCACCTAA
CCCTGGGCAGGCAAAAAACACTCCTTTACG|GGCCCTGGGCAGGCAAAAAACTTGCGGGCC
CTCCTCACACGGTGCGGCATACCTACGAAA|TTAAAAGAAATTAGGCTGACGGAAGACCAC
CACTCGAAGCTGCATGGCGCTAAGCCGTCT|AGTCTATCTTTACTCGAACAACGGTAATGT
CCAGGCACGTGAAGACAGTGGTTGCGGGCC|GTTGACTACGGGTCGCTTGCTAGATTACTC
GGAATCCCTTGCTCGTTGCGGGCCCTGGGC|AACTCCGCTATACCATATTGCGGGCCCTGG
CGTGGACTTGCACCAACCTGACCTTCTTTC|TAAGCCGTCTCAGCATAAGGCGAGTCCCGA
GGTTGCGGGCCCTGGGCAGGCAAAAAACAC|CACCATGGATGAATTAGCGCCACATCCTAT
TCATTGACTACACGAACCGGAATCCCTTGC|GCAGTCCAGGCACCACCTAACTCCGCTATA
ATCTGCTGCGTAAACCAGCTGTTGACGTGG|AAAAACACTCGAAGCTGCATGGCGCTAAGC
GGTAATGTGGTACTTGCGGGCCCTGGGCAG|GAGAGCCTGGGACAATCCTGACTGTTGCGG
GGCCCTGGGCAGGCAAAAAACACTCACGAA|GATGAATTAGCGCCACATCCTATTTTTCCA
AGAACGGGGTCTTGCCTCCTCCTTGTCTCA|ACGTCAAACTATTGTATTGACTTTTAGGGT
ACCGGAATCCCTTGCTCGTTGCGGGCCCTG|CCTAACTCCGCTATACCATATTGCGGGCCC
AACACTCACTCCGGCGAATCCACTTAGCAA|TGACAATCATTGACTACACGAACCGGAATC
ATTTGCGGGCCCTGGGCAGGCAAAAAACAC|TGGGCAGGCAAAAAACACTCAAAGTTAGCC
CACCTAACTCCGCTATACCATATTGCGGGC|AATGTGAGATGACTCTAACGCAAACTTCGT
CAAAAAACACTCCCATAGAGTCTATCTTTA|ACGGTGCGGCATACCTACGAAAGTCTGCAA
CCTGGGCAGGCAAAAAACACTCCTTTACGG|GCCCTGGGCAGGCAAAAAACTTGCGGGCCC
CTACAGGGGTTGCGGGCCCTGGGCAGGCAA|CACTGCCCACCATGGATGAATTAGCGCCAC
ACAACACCTTGCAGAACGGGGTCTTGCCTC|CGGCCTGCACACACGTCAAACTATTGTATT
CCCTGGGCAGGCAAAAAACACTCCATACTT|AAAAAACACTCAAAGTTAGCCCCTTTGTAG
GACTTTTAGGGTTCTAATGCAGTCCAGGCA|ACATTGCATTAGTAATGCGACTCATGCATC
CTCGGCCCTGGGCAGGCAAAAAACACTCGA|GCAGGCAAAAAACACTCCCATAGAGTCTAT
GCGGGCCCTGGGCAGGCAAAAAACTTGCGG|TACTTACAACACCTTGCAGAACGGGGTCTT
CCTACGAAAGTCTGCAATCGAGTGAGTGAG|GAAGACCACGTAATCGACCTTGCGGGCCCT
CAAATGTGAGATGACTCTAACGCAAACTTC|GCCCTGGGCAGGCAAAAAACACTCATACTG
ACTCCTTTACGGCACGGATCTCAGTCACCG|ACTTGCGGGCCCTGGGCAGGCAAAAAACAC
AAAAGAAATTAGGCTGACGGAAGACCACGT|TCCGGCGAATCCACTTAGCAATTCCCTCGC
CCTGGGCAGGCAAAAAACACTCAAAGTTAG|GCCCTGGGCAGGCAAAAAACACTCGCGCCC
TTTGTAGCGGCCTGCACACACGTCAAACTA|CAGCGGACGAGTTCCCTGGCCCAACCTAAA
AAACACTCGGCCCTGGGCAGGCAAAAAACA|CCTGGGCAGGCAAAAAACACTCCCATAGAG
CAGGCAAAAAACACTCGGCCCTGGGCAGGC|TTGCGGGCCCTGGGCAGGCAAAAAACACTC
CATTGACTACACGAACCGGAATCCCTTGCT|CAGTCCAGGCACCACCTAACTCCGCTATAC
GCCCTGGGCAGGCAAAAAACACTCGAAGCT|GCAAAAAACACTCCCATAGAGTCTATCTTT
CCCGACGGTGAGCACCGTTTCCGGACCTCC|TGGGCAGGCAAAAAACACTCTCTTATAGGT
TCTGCTGCGTAAACCAGCTGTTGACGTGGA|AAAACACTCGAAGCTGCATGGCGCTAAGCC
AGCCCCTTTGTAGCGGCCTGCACACACGTC|CCTATTCAGCGGACGAGTTCCCTGGCCCAA
AGTGCAAGCGTAAGACCCATCTGCTGCGTA|CTCGGCCCTGGGCAGGCAAAAAACACTCGA
CAGGCAAAAAACTTGCGGGCCCTGGGCAGG|CTTGCAGAACGGGGTCTTGCCTCCTCCTTG
GTGCGGCATACCTACGAAAGTCTGCAATCG|TAGGCTGACGGAAGACCACGTAATCGACCT
CCGTCTCAGCATAAGGCGAGTCCCGACGGT|TAATGTGGTACTTGCGGGCCCTGGGCAGGC
AGTAATGCGACTCATGCATCAAATGTGAGA|CTACCGGAGCTCCTTGCGGGCCCTGGGCAG
TGCTAGATTACTCTCTCCTCACACGGTGCG|TCTCAGTCACCGGGTTAAAAGAAATTAGGC
GCGTAAACCAGCTGTTGACGTGGACTTGCA|CTCGAAGCTGCATGGCGCTAAGCCGTCTCA
ACTCACTCCGGCGAATCCACTTAGCAATTC|CAATCATTGACTACACGAACCGGAATCCCT
CACGTACATTGCATTAGTAATGCGACTCAT|TAATAGGAATATGGGCTACCGGAGCTCCTT
GAACCGGAATCCCTTGCTCGTTGCGGGCCC|CACCTAACTCCGCTATACCATATTGCGGGC
GGGCAGGCAAAAAACACTCTGATGTGGTGG|ACGTATTGCGTTGCGGGCCCTGGGCAGGCA
TTAGCAATTCCCTCGCTGGGATTAAAATTT|CGGAATCCCTTGCTCGTTGCGGGCCCTGGG
GCCCTGGGCAGGCAAAAAACACTCCTTTAC|GGGCCCTGGGCAGGCAAAAAACTTGCGGGC
CACACGGTGCGGCATACCTACGAAAGTCTG|AGAAATTAGGCTGACGGAAGACCACGTAAT
ACACGAACCGGAATCCCTTGCTCGTTGCGG|GCACCACCTAACTCCGCTATACCATATTGC
GTTCCCTGGCCCAACCTAAAGCCACGTACA|CACTCACGAACGCAGGTTCCGTTAATAGGA
CCCTGGGCAGGCAAAAAACACTCATACTGA|AAACTGTATACCGCGTACAGTGTCTGACAC
ACCACGTAATCGACCTTGCGGGCCCTGGGC|CCCTCGCTGGGATTAAAATTTGCGGGCCCT
CTGGGCAGGCAAAAAACACTCAAAGTTAGC|CCCTGGGCAGGCAAAAAACACTCGCGCCCT
GTCCAGGCACCACCTAACTCCGCTATACCA|TCATGCATCAAATGTGAGATGACTCTAACG
GGGCCCTGGGCAGGCAAAAAACACTCTGAT|AAAGGGCACGTATTGCGTTGCGGGCCCTGG
TCGCTGGGATTAAAATTTGCGGGCCCTGGG|CTCGTTGCGGGCCCTGGGCAGGCAAAAAAC
TGAGCACCGTTTCCGGACCTCCAGGCACGT|CAAAAAACACTCTCTTATAGGTTGACTACG
AGGTTGACTACGGGTCGCTTGCTAGATTAC|CACTCCTTTACGGCACGGATCTCAGTCACC
AGCTCCTTGCGGGCCCTGGGCAGGCAAAAA|CTGTCGGGCATTTAAACTGTATACCGCGTA
GGGCCCTGGGCAGGCAAAAAACACTCGGCC|AAGACAGTGGTTGCGGGCCCTGGGCAGGCA
GGCAAAAAACACTCTCTTATAGGTTGACTA|GGCCCTGGGCAGGCAAAAAACACTCCTTTA
TGGGCAGGCAAAAAACACTCGGCCCTGGGC|GTGGTTGCGGGCCCTGGGCAGGCAAAAAAC
TGGGCAGGCAAAAAACACTCATACTGAACT|CTGTATACCGCGTACAGTGTCTGACACCGC
CTGGCCCAACCTAAAGCCACGTACATTGCA|ACGAACGCAGGTTCCGTTAATAGGAATATG
TGAGATGACTCTAACGCAAACTTCGTCTAC|GGCAGGCAAAAAACACTCATACTGAACTTA
CCGGGTTAAAAGAAATTAGGCTGACGGAAG|CACTCACTCCGGCGAATCCACTTAGCAATT
CGTATTGCGTTGCGGGCCCTGGGCAGGCAA|CTCCAGGCACGTGAAGACAGTGGTTGCGGG
CTGGGCAGGCAAAAAACACTCGAAGCTGCA|AAAAACACTCCCATAGAGTCTATCTTTACT
TGCGGGCCCTGGGCAGGCAAAAAACACTCG|GTGAAGACAGTGGTTGCGGGCCCTGGGCAG
TAAAAGAAATTAGGCTGACGGAAGACCACG|CTCCGGCGAATCCACTTAGCAATTCCCTCG
ACTTGCACCAACCTGACCTTCTTTCCATGG|CGTCTCAGCATAAGGCGAGTCCCGACGGTG
GCGAGTCCCGACGGTGAGCACCGTTTCCGG|GGGCCCTGGGCAGGCAAAAAACACTCTCTT
AGCGGCCTGCACACACGTCAAACTATTGTA|GACGAGTTCCCTGGCCCAACCTAAAGCCAC
AAACACTCACGAACGCAGGTTCCGTTAATA|TCCTATTTTTCCACCCAGTGGCATTCGGCA
AAAGCCACGTACATTGCATTAGTAATGCGA|TCCGTTAATAGGAATATGGGCTACCGGAGC
TCTAATGCAGTCCAGGCACCACCTAACTCC|TAATGCGACTCATGCATCAAATGTGAGATG
CGGGCCCTGGGCAGGCAAAAAACACTCACG|TGGATGAATTAGCGCCACATCCTATTTTTC
CCTGGGCAGGCAAAAAACACTCACTCCGGC|CTCCTCCTTGTCTCATGACAATCATTGACT
GCAAACTTCGTCTACACCACTACAGGGGTT|CTCATACTGAACTTAGCGACACTGCCCACC
AGCTGCATGGCGCTAAGCCGTCTCAGCATA|CTTTACTCGAACAACGGTAATGTGGTACTT
CGCTATACCATATTGCGGGCCCTGGGCAGG|GACTCTAACGCAAACTTCGTCTACACCACT
AATGCAGTCCAGGCACCACCTAACTCCGCT|TGCGACTCATGCATCAAATGTGAGATGACT
CTCCTCCTTGTCTCATGACAATCATTGACT|ATTGACTTTTAGGGTTCTAATGCAGTCCAG
ACCCATCTGCTGCGTAAACCAGCTGTTGAC|GGCAAAAAACACTCGAAGCTGCATGGCGCT
GGCAGGCAAAAAACTTGCGGGCCCTGGGCA|ACCTTGCAGAACGGGGTCTTGCCTCCTCCT
GCCTGCACACACGTCAAACTATTGTATTGA|AGTTCCCTGGCCCAACCTAAAGCCACGTAC
GCAAGCGTAAGACCCATCTGCTGCGTAAAC|GGCCCTGGGCAGGCAAAAAACACTCGAAGC
ACAGTGGTTGCGGGCCCTGGGCAGGCAAAA|GCTTGCTAGATTACTCTCTCCTCACACGGT
GTTCCGTTAATAGGAATATGGGCTACCGGA|TGGCATTCGGCATACCATAGTTAGCTCTCC
CTTAAAAGGGCACGTATTGCGTTGCGGGCC|CCGTTTCCGGACCTCCAGGCACGTGAAGAC
CCGGAATCCCTTGCTCGTTGCGGGCCCTGG|CTAACTCCGCTATACCATATTGCGGGCCCT
TCTAACGCAAACTTCGTCTACACCACTACA|AAAACACTCATACTGAACTTAGCGACACTG
TGACAATCATTGACTACACGAACCGGAATC|TCTAATGCAGTCCAGGCACCACCTAACTCC
AGAGCCTGGGACAATCCTGACTGTTGCGGG|CTGGGCAGGCAAAAAACACTCACCCTTGCG
GCTACCGGAGCTCCTTGCGGGCCCTGGGCA|TAGCTCTCCTGTCGGGCATTTAAACTGTAT
GGCAAAAAACACTCACCCTTGCGGGCCCTG|GGCAGGCAAAAAACACTCCATACTTACAAC
TTGCCTCCTCCTTGTCTCATGACAATCATT|TTGTATTGACTTTTAGGGTTCTAATGCAGT
CATGTTTTGCGGGCCCTGGGCAGGCAAAAA|GACTTGCACCAACCTGACCTTCTTTCCATG
GAGCCTGGGACAATCCTGACTGTTGCGGGC|TGGGCAGGCAAAAAACACTCACCCTTGCGG
CAGTGGTTGCGGGCCCTGGGCAGGCAAAAA|CTTGCTAGATTACTCTCTCCTCACACGGTG
GCATACCTACGAAAGTCTGCAATCGAGTGA|TGACGGAAGACCACGTAATCGACCTTGCGG
TGACTACGGGTCGCTTGCTAGATTACTCTC|CCTTTACGGCACGGATCTCAGTCACCGGGT
AATTAGGCTGACGGAAGACCACGTAATCGA|GAATCCACTTAGCAATTCCCTCGCTGGGAT
GGCCCTGGGCAGGCAAAAAACACTCCATAC|GCAAAAAACACTCAAAGTTAGCCCCTTTGT
CGAAAGTCTGCAATCGAGTGAGTGAGAGCC|ACCACGTAATCGACCTTGCGGGCCCTGGGC
TATACCATATTGCGGGCCCTGGGCAGGCAA|TCTAACGCAAACTTCGTCTACACCACTACA
CCGGAGCTCCTTGCGGGCCCTGGGCAGGCA|TCTCCTGTCGGGCATTTAAACTGTATACCG
AGTCGGAGTGCAAGCGTAAGACCCATCTGC|AAAACACTCGGCCCTGGGCAGGCAAAAAAC
ATACCTACGAAAGTCTGCAATCGAGTGAGT|ACGGAAGACCACGTAATCGACCTTGCGGGC
CCTTCTTTCCATGGTACGCTTAAAAGGGCA|GAGTCCCGACGGTGAGCACCGTTTCCGGAC
CACTCTCTTATAGGTTGACTACGGGTCGCT|CAGGCAAAAAACACTCCTTTACGGCACGGA
GACGGTGAGCACCGTTTCCGGACCTCCAGG|GCAGGCAAAAAACACTCTCTTATAGGTTGA
CATCGTGCTTCCTATTCATGTTTTGCGGGC|ACCAGCTGTTGACGTGGACTTGCACCAACC
ATAAGGCGAGTCCCGACGGTGAGCACCGTT|CTTGCGGGCCCTGGGCAGGCAAAAAACACT
CAACCTAAAGCCACGTACATTGCATTAGTA|GCAGGTTCCGTTAATAGGAATATGGGCTAC
AGGCAAAAAACACTCCTTTACGGCACGGAT|GCAGGCAAAAAACTTGCGGGCCCTGGGCAG
TATTCAGCGGACGAGTTCCCTGGCCCAACC|GGGCAGGCAAAAAACACTCACGAACGCAGG
CAACCTGACCTTCTTTCCATGGTACGCTTA|CATAAGGCGAGTCCCGACGGTGAGCACCGT
TGGGCAGGCAAAAAACACTCGCGCCCTATT|ACACCACTACAGGGGTTGCGGGCCCTGGGC
CCTGGGCAGGCAAAAAACACTCGCGCCCTA|CTACACCACTACAGGGGTTGCGGGCCCTGG
AAAAAACACTCTGATGTGGTGGAAGTCGGA|CGTTGCGGGCCCTGGGCAGGCAAAAAACAC
TGACTACACGAACCGGAATCCCTTGCTCGT|TCCAGGCACCACCTAACTCCGCTATACCAT
TGTTTTGCGGGCCCTGGGCAGGCAAAAAAC|CTTGCACCAACCTGACCTTCTTTCCATGGT
AAGGCGAGTCCCGACGGTGAGCACCGTTTC|TGCGGGCCCTGGGCAGGCAAAAAACACTCT
GTGGTTGCGGGCCCTGGGCAGGCAAAAAAC|TGCTAGATTACTCTCTCCTCACACGGTGCG
TTGCGGGCCCTGGGCAGGCAAAAAACACTC|AACTTCGTCTACACCACTACAGGGGTTGCG
GGACCTCCAGGCACGTGAAGACAGTGGTTG|TTATAGGTTGACTACGGGTCGCTTGCTAGA
CAAAAAACACTCGGCCCTGGGCAGGCAAAA|GGGCCCTGGGCAGGCAAAAAACACTCCCAT
GCGTAAGACCCATCTGCTGCGTAAACCAGC|CTGGGCAGGCAAAAAACACTCGAAGCTGCA
GGCAAAAAACTTGCGGGCCCTGGGCAGGCA|TGCAGAACGGGGTCTTGCCTCCTCCTTGTC
CAGGCACGTGAAGACAGTGGTTGCGGGCCC|TTGACTACGGGTCGCTTGCTAGATTACTCT
TTAGGGTTCTAATGCAGTCCAGGCACCACC|GCATTAGTAATGCGACTCATGCATCAAATG
TTGCGGGCCCTGGGCAGGCAAAAAACACTC|AGATTACTCTCTCCTCACACGGTGCGGCAT
TCCCTCGCTGGGATTAAAATTTGCGGGCCC|CTTGCTCGTTGCGGGCCCTGGGCAGGCAAA
CAGGCAAAAAACACTCCCATAGAGTCTATC|TCACACGGTGCGGCATACCTACGAAAGTCT
AGCTGTTGACGTGGACTTGCACCAACCTGA|GCATGGCGCTAAGCCGTCTCAGCATAAGGC
ATGACAATCATTGACTACACGAACCGGAAT|TTCTAATGCAGTCCAGGCACCACCTAACTC
AACGGGGTCTTGCCTCCTCCTTGTCTCATG|GTCAAACTATTGTATTGACTTTTAGGGTTC
GGCCCTGGGCAGGCAAAAAACACTCCCATA|ACTCTCTCCTCACACGGTGCGGCATACCTA
TATTCATGTTTTGCGGGCCCTGGGCAGGCA|CGTGGACTTGCACCAACCTGACCTTCTTTC
CGGTGAGCACCGTTTCCGGACCTCCAGGCA|AGGCAAAAAACACTCTCTTATAGGTTGACT
ACTACAGGGGTTGCGGGCCCTGGGCAGGCA|ACACTGCCCACCATGGATGAATTAGCGCCA
TAGGCTGACGGAAGACCACGTAATCGACCT|TCCACTTAGCAATTCCCTCGCTGGGATTAA
GGCAAAAAACACTCGCGCCCTATTCAGCGG|CTACAGGGGTTGCGGGCCCTGGGCAGGCAA
GCAGGCAAAAAACACTCCCATAGAGTCTAT|CTCACACGGTGCGGCATACCTACGAAAGTC
GGCCTGCACACACGTCAAACTATTGTATTG|GAGTTCCCTGGCCCAACCTAAAGCCACGTA
CTATCTTTACTCGAACAACGGTAATGTGGT|AGTCTGCAATCGAGTGAGTGAGAGCCTGGG
GCACCAACCTGACCTTCTTTCCATGGTACG|TCAGCATAAGGCGAGTCCCGACGGTGAGCA
AGGAATATGGGCTACCGGAGCTCCTTGCGG|ATACCATAGTTAGCTCTCCTGTCGGGCATT
AAACACTCTGATGTGGTGGAAGTCGGAGTG|TGCGGGCCCTGGGCAGGCAAAAAACACTCG
CACTCCATACTTACAACACCTTGCAGAACG|GCCCCTTTGTAGCGGCCTGCACACACGTCA
AAAACACTCTGCGGGCCCTGGGCAGGCAAA|ATGGTACGCTTAAAAGGGCACGTATTGCGT
GTCAAACTATTGTATTGACTTTTAGGGTTC|CAACCTAAAGCCACGTACATTGCATTAGTA
TACCTACGAAAGTCTGCAATCGAGTGAGTG|CGGAAGACCACGTAATCGACCTTGCGGGCC
ATTGCATTAGTAATGCGACTCATGCATCAA|AATATGGGCTACCGGAGCTCCTTGCGGGCC
ACCAGCTGTTGACGTGGACTTGCACCAACC|GCTGCATGGCGCTAAGCCGTCTCAGCATAA
TAGGGTTCTAATGCAGTCCAGGCACCACCT|CATTAGTAATGCGACTCATGCATCAAATGT
ACGTGGACTTGCACCAACCTGACCTTCTTT|CTAAGCCGTCTCAGCATAAGGCGAGTCCCG
CCTGACTGTTGCGGGCCCTGGGCAGGCAAA|ACACTCACCCTTGCGGGCCCTGGGCAGGCA
ACGGTAATGTGGTACTTGCGGGCCCTGGGC|GTGAGAGCCTGGGACAATCCTGACTGTTGC
TGCGGGCCCTGGGCAGGCAAAAAACACTCC|CTTGCGGGCCCTGGGCAGGCAAAAAACTTG
CCTGGGCAGGCAAAAAACACTCATACTGAA|AACTGTATACCGCGTACAGTGTCTGACACC
TACGGGTCGCTTGCTAGATTACTCTCTCCT|TACGGCACGGATCTCAGTCACCGGGTTAAA
TCCTTTACGGCACGGATCTCAGTCACCGGG|TTGCGGGCCCTGGGCAGGCAAAAAACACTC
ACGTACATTGCATTAGTAATGCGACTCATG|AATAGGAATATGGGCTACCGGAGCTCCTTG
GCAAAAAACACTCGAAGCTGCATGGCGCTA|TCCCATAGAGTCTATCTTTACTCGAACAAC
GCGGGCCCTGGGCAGGCAAAAAACACTCTG|TAAAAGGGCACGTATTGCGTTGCGGGCCCT
TTGCGGGCCCTGGGCAGGCAAAAAACTTGC|CATACTTACAACACCTTGCAGAACGGGGTC
GCAGGCAAAAAACACTCTCTTATAGGTTGA|GCGGGCCCTGGGCAGGCAAAAAACACTCCT
GGTTGACTACGGGTCGCTTGCTAGATTACT|ACTCCTTTACGGCACGGATCTCAGTCACCG
ACACTCAAAGTTAGCCCCTTTGTAGCGGCC|AAACACTCGCGCCCTATTCAGCGGACGAGT
GACAATCATTGACTACACGAACCGGAATCC|CTAATGCAGTCCAGGCACCACCTAACTCCG
AAAACACTCGGCCCTGGGCAGGCAAAAAAC|CCCTGGGCAGGCAAAAAACACTCCCATAGA
ACACTCTGCGGGCCCTGGGCAGGCAAAAAA|GTACGCTTAAAAGGGCACGTATTGCGTTGC
ACACCACTACAGGGGTTGCGGGCCCTGGGC|TAGCGACACTGCCCACCATGGATGAATTAG
CTACGAAAGTCTGCAATCGAGTGAGTGAGA|AAGACCACGTAATCGACCTTGCGGGCCCTG
ATTGACTTTTAGGGTTCTAATGCAGTCCAG|CGTACATTGCATTAGTAATGCGACTCATGC
GCTTGCTAGATTACTCTCTCCTCACACGGT|GGATCTCAGTCACCGGGTTAAAAGAAATTA
GCAAAAAACACTCCATACTTACAACACCTT|CAAAGTTAGCCCCTTTGTAGCGGCCTGCAC
CCTCGCTGGGATTAAAATTTGCGGGCCCTG|TGCTCGTTGCGGGCCCTGGGCAGGCAAAAA
TGTAGCGGCCTGCACACACGTCAAACTATT|GCGGACGAGTTCCCTGGCCCAACCTAAAGC
ACACGTCAAACTATTGTATTGACTTTTAGG|GGCCCAACCTAAAGCCACGTACATTGCATT
AGAGTCTATCTTTACTCGAACAACGGTAAT|ACGAAAGTCTGCAATCGAGTGAGTGAGAGC
CCTGGGCAGGCAAAAAACTTGCGGGCCCTG|CAACACCTTGCAGAACGGGGTCTTGCCTCC
AAAAAACACTCTCTTATAGGTTGACTACGG|CCTGGGCAGGCAAAAAACACTCCTTTACGG
GATTACTCTCTCCTCACACGGTGCGGCATA|GTCACCGGGTTAAAAGAAATTAGGCTGACG
CTCACCCTTGCGGGCCCTGGGCAGGCAAAA|AACACTCCATACTTACAACACCTTGCAGAA
AACCTGACCTTCTTTCCATGGTACGCTTAA|ATAAGGCGAGTCCCGACGGTGAGCACCGTT
GACTCATGCATCAAATGTGAGATGACTCTA|GCTCCTTGCGGGCCCTGGGCAGGCAAAAAA
ATCCCTTGCTCGTTGCGGGCCCTGGGCAGG|TCCGCTATACCATATTGCGGGCCCTGGGCA
ACTCATGCATCAAATGTGAGATGACTCTAA|CTCCTTGCGGGCCCTGGGCAGGCAAAAAAC
AATATGGGCTACCGGAGCTCCTTGCGGGCC|CCATAGTTAGCTCTCCTGTCGGGCATTTAA
TCTTTACTCGAACAACGGTAATGTGGTACT|CTGCAATCGAGTGAGTGAGAGCCTGGGACA
GTCGCTTGCTAGATTACTCTCTCCTCACAC|CACGGATCTCAGTCACCGGGTTAAAAGAAA
CCCTTGCTCGTTGCGGGCCCTGGGCAGGCA|CGCTATACCATATTGCGGGCCCTGGGCAGG
CACTACAGGGGTTGCGGGCCCTGGGCAGGC|GACACTGCCCACCATGGATGAATTAGCGCC
CCCTGGGCAGGCAAAAAACACTCGAAGCTG|CAAAAAACACTCCCATAGAGTCTATCTTTA
GTGGACTTGCACCAACCTGACCTTCTTTCC|AAGCCGTCTCAGCATAAGGCGAGTCCCGAC
GGCAAAAAACACTCACTCCGGCGAATCCAC|TGTCTCATGACAATCATTGACTACACGAAC
AGCAATTCCCTCGCTGGGATTAAAATTTGC|GAATCCCTTGCTCGTTGCGGGCCCTGGGCA
TAATGCAGTCCAGGCACCACCTAACTCCGC|ATGCGACTCATGCATCAAATGTGAGATGAC
TTAATAGGAATATGGGCTACCGGAGCTCCT|TCGGCATACCATAGTTAGCTCTCCTGTCGG
TTGACTACACGAACCGGAATCCCTTGCTCG|GTCCAGGCACCACCTAACTCCGCTATACCA
TGTATTGACTTTTAGGGTTCTAATGCAGTC|CCACGTACATTGCATTAGTAATGCGACTCA
TCACCCTTGCGGGCCCTGGGCAGGCAAAAA|ACACTCCATACTTACAACACCTTGCAGAAC
ATCGACCTTGCGGGCCCTGGGCAGGCAAAA|GGGATTAAAATTTGCGGGCCCTGGGCAGGC
ATTCCCTCGCTGGGATTAAAATTTGCGGGC|CCCTTGCTCGTTGCGGGCCCTGGGCAGGCA
ATAGAGTCTATCTTTACTCGAACAACGGTA|CTACGAAAGTCTGCAATCGAGTGAGTGAGA
ATGGCGCTAAGCCGTCTCAGCATAAGGCGA|TCGAACAACGGTAATGTGGTACTTGCGGGC
CCACCTAACTCCGCTATACCATATTGCGGG|AAATGTGAGATGACTCTAACGCAAACTTCG
GCAATCGAGTGAGTGAGAGCCTGGGACAAT|TCGACCTTGCGGGCCCTGGGCAGGCAAAAA
GCATGGCGCTAAGCCGTCTCAGCATAAGGC|ACTCGAACAACGGTAATGTGGTACTTGCGG
TAGGTTGACTACGGGTCGCTTGCTAGATTA|ACACTCCTTTACGGCACGGATCTCAGTCAC
TTGCGGGCCCTGGGCAGGCAAAAAACACTC|GGCATTTAAACTGTATACCGCGTACAGTGT
CGGGCCCTGGGCAGGCAAAAAACTTGCGGG|ACTTACAACACCTTGCAGAACGGGGTCTTG
GTCTGCAATCGAGTGAGTGAGAGCCTGGGA|GTAATCGACCTTGCGGGCCCTGGGCAGGCA
GATGTGGTGGAAGTCGGAGTGCAAGCGTAA|TGGGCAGGCAAAAAACACTCGGCCCTGGGC
TGGTTGCGGGCCCTGGGCAGGCAAAAAACA|GCTAGATTACTCTCTCCTCACACGGTGCGG
TCCGGACCTCCAGGCACGTGAAGACAGTGG|CTCTTATAGGTTGACTACGGGTCGCTTGCT
CTTAGCAATTCCCTCGCTGGGATTAAAATT|CCGGAATCCCTTGCTCGTTGCGGGCCCTGG
TTCCGTTAATAGGAATATGGGCTACCGGAG|GGCATTCGGCATACCATAGTTAGCTCTCCT
TGATGTGGTGGAAGTCGGAGTGCAAGCGTA|CTGGGCAGGCAAAAAACACTCGGCCCTGGG
CTGGGCAGGCAAAAAACACTCCATACTTAC|AAAACACTCAAAGTTAGCCCCTTTGTAGCG
GTAATCGACCTTGCGGGCCCTGGGCAGGCA|GCTGGGATTAAAATTTGCGGGCCCTGGGCA
CACACACGTCAAACTATTGTATTGACTTTT|CCTGGCCCAACCTAAAGCCACGTACATTGC
TTGCACCAACCTGACCTTCTTTCCATGGTA|TCTCAGCATAAGGCGAGTCCCGACGGTGAG
GCGGGCCCTGGGCAGGCAAAAAACACTCAC|TCTTGCCTCCTCCTTGTCTCATGACAATCA
GCAGGCAAAAAACACTCGGCCCTGGGCAGG|GTTGCGGGCCCTGGGCAGGCAAAAAACACT
AACACTCACGAACGCAGGTTCCGTTAATAG|CCTATTTTTCCACCCAGTGGCATTCGGCAT
TTTTGCGGGCCCTGGGCAGGCAAAAAACAC|TGCACCAACCTGACCTTCTTTCCATGGTAC
CCGGCGAATCCACTTAGCAATTCCCTCGCT|TGACTACACGAACCGGAATCCCTTGCTCGT
CGACCTTGCGGGCCCTGGGCAGGCAAAAAA|GATTAAAATTTGCGGGCCCTGGGCAGGCAA
TTAAAAGGGCACGTATTGCGTTGCGGGCCC|CGTTTCCGGACCTCCAGGCACGTGAAGACA
TTTCCGGACCTCCAGGCACGTGAAGACAGT|CTCTCTTATAGGTTGACTACGGGTCGCTTG
GTTGCGGGCCCTGGGCAGGCAAAAAACACT|ATATTGCGGGCCCTGGGCAGGCAAAAAACA
GCGGGCCCTGGGCAGGCAAAAAACACTCAC|ATTTGCGGGCCCTGGGCAGGCAAAAAACAC
TGCGGGCCCTGGGCAGGCAAAAAACACTCA|CATGGATGAATTAGCGCCACATCCTATTTT
CGGGCCCTGGGCAGGCAAAAAACACTCGGC|GAAGACAGTGGTTGCGGGCCCTGGGCAGGC
TTACTCTCTCCTCACACGGTGCGGCATACC|CACCGGGTTAAAAGAAATTAGGCTGACGGA
CGGTAATGTGGTACTTGCGGGCCCTGGGCA|TGAGAGCCTGGGACAATCCTGACTGTTGCG
CCTTTGTAGCGGCCTGCACACACGTCAAAC|TTCAGCGGACGAGTTCCCTGGCCCAACCTA
GCCACGTACATTGCATTAGTAATGCGACTC|GTTAATAGGAATATGGGCTACCGGAGCTCC
AAAACACTCTCTTATAGGTTGACTACGGGT|TGGGCAGGCAAAAAACACTCCTTTACGGCA
TGCTTCCTATTCATGTTTTGCGGGCCCTGG|CTGTTGACGTGGACTTGCACCAACCTGACC
CTCGAAGCTGCATGGCGCTAAGCCGTCTCA|TCTATCTTTACTCGAACAACGGTAATGTGG
CTTTTAGGGTTCTAATGCAGTCCAGGCACC|ATTGCATTAGTAATGCGACTCATGCATCAA
CAAGCGTAAGACCCATCTGCTGCGTAAACC|GCCCTGGGCAGGCAAAAAACACTCGAAGCT
ACGCAAACTTCGTCTACACCACTACAGGGG|CACTCATACTGAACTTAGCGACACTGCCCA
AGTCCAGGCACCACCTAACTCCGCTATACC|CTCATGCATCAAATGTGAGATGACTCTAAC
TCGCTTGCTAGATTACTCTCTCCTCACACG|ACGGATCTCAGTCACCGGGTTAAAAGAAAT
TGGTACTTGCGGGCCCTGGGCAGGCAAAAA|TGGGACAATCCTGACTGTTGCGGGCCCTGG
TTGTAGCGGCCTGCACACACGTCAAACTAT|AGCGGACGAGTTCCCTGGCCCAACCTAAAG
GGGGTCTTGCCTCCTCCTTGTCTCATGACA|AAACTATTGTATTGACTTTTAGGGTTCTAA
ACTCTAACGCAAACTTCGTCTACACCACTA|AAAAAACACTCATACTGAACTTAGCGACAC
GGGCCCTGGGCAGGCAAAAAACACTCACTC|TTGCCTCCTCCTTGTCTCATGACAATCATT
GTACTTGCGGGCCCTGGGCAGGCAAAAAAC|GGACAATCCTGACTGTTGCGGGCCCTGGGC
GCGGCATACCTACGAAAGTCTGCAATCGAG|GGCTGACGGAAGACCACGTAATCGACCTTG
ACCTTCTTTCCATGGTACGCTTAAAAGGGC|CGAGTCCCGACGGTGAGCACCGTTTCCGGA
CGTGAAGACAGTGGTTGCGGGCCCTGGGCA|ACGGGTCGCTTGCTAGATTACTCTCTCCTC
CACCATCGTGCTTCCTATTCATGTTTTGCG|TAAACCAGCTGTTGACGTGGACTTGCACCA
GCCGTCTCAGCATAAGGCGAGTCCCGACGG|GTAATGTGGTACTTGCGGGCCCTGGGCAGG
GGCCCTGGGCAGGCAAAAAACACTCTGATG|AAGGGCACGTATTGCGTTGCGGGCCCTGGG
CTAGATTACTCTCTCCTCACACGGTGCGGC|TCAGTCACCGGGTTAAAAGAAATTAGGCTG
AAAAACACTCCCATAGAGTCTATCTTTACT|GGTGCGGCATACCTACGAAAGTCTGCAATC
GCACCATCGTGCTTCCTATTCATGTTTTGC|GTAAACCAGCTGTTGACGTGGACTTGCACC
ACACTCACCCTTGCGGGCCCTGGGCAGGCA|AAAAACACTCCATACTTACAACACCTTGCA
AAAAAACACTCGAAGCTGCATGGCGCTAAG|CCATAGAGTCTATCTTTACTCGAACAACGG
TTAGGCTGACGGAAGACCACGTAATCGACC|ATCCACTTAGCAATTCCCTCGCTGGGATTA
GCTGCATGGCGCTAAGCCGTCTCAGCATAA|TTTACTCGAACAACGGTAATGTGGTACTTG
GCAAAAAACACTCACTCCGGCGAATCCACT|GTCTCATGACAATCATTGACTACACGAACC
ATTAGTAATGCGACTCATGCATCAAATGTG|GGGCTACCGGAGCTCCTTGCGGGCCCTGGG
TCTCAGTCACCGGGTTAAAAGAAATTAGGC|GGCAAAAAACACTCACTCCGGCGAATCCAC
CTGCATGGCGCTAAGCCGTCTCAGCATAAG|TTACTCGAACAACGGTAATGTGGTACTTGC
CGAATCCACTTAGCAATTCCCTCGCTGGGA|TACACGAACCGGAATCCCTTGCTCGTTGCG
AACCGGAATCCCTTGCTCGTTGCGGGCCCT|ACCTAACTCCGCTATACCATATTGCGGGCC
TACGCTTAAAAGGGCACGTATTGCGTTGCG|AGCACCGTTTCCGGACCTCCAGGCACGTGA
TAGCCCCTTTGTAGCGGCCTGCACACACGT|CCCTATTCAGCGGACGAGTTCCCTGGCCCA
AAAAAACACTCCATACTTACAACACCTTGC|AAGTTAGCCCCTTTGTAGCGGCCTGCACAC
AATCCACTTAGCAATTCCCTCGCTGGGATT|CACGAACCGGAATCCCTTGCTCGTTGCGGG
TGCGGGCCCTGGGCAGGCAAAAAACACTCA|GCATTTAAACTGTATACCGCGTACAGTGTC
ACCAACCTGACCTTCTTTCCATGGTACGCT|AGCATAAGGCGAGTCCCGACGGTGAGCACC
AAAAAACACTCAAAGTTAGCCCCTTTGTAG|GCAAAAAACACTCGCGCCCTATTCAGCGGA
TAACGCAAACTTCGTCTACACCACTACAGG|AACACTCATACTGAACTTAGCGACACTGCC
CCGTTAATAGGAATATGGGCTACCGGAGCT|CATTCGGCATACCATAGTTAGCTCTCCTGT
CGCTAAGCCGTCTCAGCATAAGGCGAGTCC|ACAACGGTAATGTGGTACTTGCGGGCCCTG
TGCGGGCCCTGGGCAGGCAAAAAACTTGCG|ATACTTACAACACCTTGCAGAACGGGGTCT
CGTTAATAGGAATATGGGCTACCGGAGCTC|ATTCGGCATACCATAGTTAGCTCTCCTGTC
TGCGGGCCCTGGGCAGGCAAAAAACACTCC|GATTACTCTCTCCTCACACGGTGCGGCATA
ACTGTTGCGGGCCCTGGGCAGGCAAAAAAC|TCACCCTTGCGGGCCCTGGGCAGGCAAAAA
GGCAAAAAACACTCAAAGTTAGCCCCTTTG|CAGGCAAAAAACACTCGCGCCCTATTCAGC
ACGGTGAGCACCGTTTCCGGACCTCCAGGC|CAGGCAAAAAACACTCTCTTATAGGTTGAC
TGGTGGAAGTCGGAGTGCAAGCGTAAGACC|CAGGCAAAAAACACTCGGCCCTGGGCAGGC
GGGCAGGCAAAAAACACTCATACTGAACTT|TGTATACCGCGTACAGTGTCTGACACCGCG
GCTTCCTATTCATGTTTTGCGGGCCCTGGG|TGTTGACGTGGACTTGCACCAACCTGACCT
GAATATGGGCTACCGGAGCTCCTTGCGGGC|ACCATAGTTAGCTCTCCTGTCGGGCATTTA
CTCTCTTATAGGTTGACTACGGGTCGCTTG|GGCAAAAAACACTCCTTTACGGCACGGATC
CAGGCAAAAAACACTCCTTTACGGCACGGA|GGCAGGCAAAAAACTTGCGGGCCCTGGGCA
TCAAACTATTGTATTGACTTTTAGGGTTCT|AACCTAAAGCCACGTACATTGCATTAGTAA
AACGCAAACTTCGTCTACACCACTACAGGG|ACACTCATACTGAACTTAGCGACACTGCCC
TCAAAGTTAGCCCCTTTGTAGCGGCCTGCA|ACTCGCGCCCTATTCAGCGGACGAGTTCCC
CGGAGTGCAAGCGTAAGACCCATCTGCTGC|ACACTCGGCCCTGGGCAGGCAAAAAACACT
ACCTGACCTTCTTTCCATGGTACGCTTAAA|TAAGGCGAGTCCCGACGGTGAGCACCGTTT
ACGTAATCGACCTTGCGGGCCCTGGGCAGG|TCGCTGGGATTAAAATTTGCGGGCCCTGGG
TGGGCAGGCAAAAAACACTCACTCCGGCGA|CCTCCTTGTCTCATGACAATCATTGACTAC
AAGAAATTAGGCTGACGGAAGACCACGTAA|CGGCGAATCCACTTAGCAATTCCCTCGCTG
GCAAAAAACACTCACCCTTGCGGGCCCTGG|GCAGGCAAAAAACACTCCATACTTACAACA
TAAGCCGTCTCAGCATAAGGCGAGTCCCGA|ACGGTAATGTGGTACTTGCGGGCCCTGGGC
TAATCGACCTTGCGGGCCCTGGGCAGGCAA|CTGGGATTAAAATTTGCGGGCCCTGGGCAG
AAAAAACACTCACCCTTGCGGGCCCTGGGC|AGGCAAAAAACACTCCATACTTACAACACC
GGTCTTGCCTCCTCCTTGTCTCATGACAAT|ACTATTGTATTGACTTTTAGGGTTCTAATG
GGTGAGCACCGTTTCCGGACCTCCAGGCAC|GGCAAAAAACACTCTCTTATAGGTTGACTA
CTTCCTATTCATGTTTTGCGGGCCCTGGGC|GTTGACGTGGACTTGCACCAACCTGACCTT
CTCGTTGCGGGCCCTGGGCAGGCAAAAAAC|ACCATATTGCGGGCCCTGGGCAGGCAAAAA
CAATCCTGACTGTTGCGGGCCCTGGGCAGG|AAAAACACTCACCCTTGCGGGCCCTGGGCA
TTGCGGGCCCTGGGCAGGCAAAAAACACTC|CCATGGATGAATTAGCGCCACATCCTATTT
AAAAACACTCAAAGTTAGCCCCTTTGTAGC|CAAAAAACACTCGCGCCCTATTCAGCGGAC
TAAGGCGAGTCCCGACGGTGAGCACCGTTT|TTGCGGGCCCTGGGCAGGCAAAAAACACTC
CTACACGAACCGGAATCCCTTGCTCGTTGC|AGGCACCACCTAACTCCGCTATACCATATT
GCGACTCATGCATCAAATGTGAGATGACTC|GAGCTCCTTGCGGGCCCTGGGCAGGCAAAA
GGGCAGGCAAAAAACACTCACCCTTGCGGG|CCCTGGGCAGGCAAAAAACACTCCATACTT
AAACACTCGAAGCTGCATGGCGCTAAGCCG|TAGAGTCTATCTTTACTCGAACAACGGTAA
CCTTGCGGGCCCTGGGCAGGCAAAAAACAC|TAAAATTTGCGGGCCCTGGGCAGGCAAAAA
ACGGAAGACCACGTAATCGACCTTGCGGGC|AGCAATTCCCTCGCTGGGATTAAAATTTGC
AGTGGTTGCGGGCCCTGGGCAGGCAAAAAA|TTGCTAGATTACTCTCTCCTCACACGGTGC
TCTCTCCTCACACGGTGCGGCATACCTACG|GGGTTAAAAGAAATTAGGCTGACGGAAGAC
CTCTCCTCACACGGTGCGGCATACCTACGA|GGTTAAAAGAAATTAGGCTGACGGAAGACC
TACATTGCATTAGTAATGCGACTCATGCAT|AGGAATATGGGCTACCGGAGCTCCTTGCGG
AACTTCGTCTACACCACTACAGGGGTTGCG|ATACTGAACTTAGCGACACTGCCCACCATG
CTGGGCAGGCAAAAAACACTCCTTTACGGC|CCCTGGGCAGGCAAAAAACTTGCGGGCCCT
CTTGCGGGCCCTGGGCAGGCAAAAAACACT|AAAATTTGCGGGCCCTGGGCAGGCAAAAAA
CGTGCTTCCTATTCATGTTTTGCGGGCCCT|AGCTGTTGACGTGGACTTGCACCAACCTGA
ATCGTGCTTCCTATTCATGTTTTGCGGGCC|CCAGCTGTTGACGTGGACTTGCACCAACCT
TGGGCTACCGGAGCTCCTTGCGGGCCCTGG|AGTTAGCTCTCCTGTCGGGCATTTAAACTG
ACGGTGCGGCATACCTACGAAAGTCTGCAA|AATTAGGCTGACGGAAGACCACGTAATCGA
GACCACGTAATCGACCTTGCGGGCCCTGGG|TCCCTCGCTGGGATTAAAATTTGCGGGCCC
TCCTCCTTGTCTCATGACAATCATTGACTA|TTGACTTTTAGGGTTCTAATGCAGTCCAGG
ACGTGAAGACAGTGGTTGCGGGCCCTGGGC|TACGGGTCGCTTGCTAGATTACTCTCTCCT
GGGCACGTATTGCGTTGCGGGCCCTGGGCA|CGGACCTCCAGGCACGTGAAGACAGTGGTT
CAAAAAACACTCTGCGGGCCCTGGGCAGGC|TCCATGGTACGCTTAAAAGGGCACGTATTG
GGAGCTCCTTGCGGGCCCTGGGCAGGCAAA|TCCTGTCGGGCATTTAAACTGTATACCGCG
TGAAGACAGTGGTTGCGGGCCCTGGGCAGG|GGGTCGCTTGCTAGATTACTCTCTCCTCAC
TTTGCGGGCCCTGGGCAGGCAAAAAACACT|GGGCAGGCAAAAAACACTCAAAGTTAGCCC
TTGCTCGTTGCGGGCCCTGGGCAGGCAAAA|TATACCATATTGCGGGCCCTGGGCAGGCAA
GCCCTGGGCAGGCAAAAAACACTCATACTG|TAAACTGTATACCGCGTACAGTGTCTGACA
CTAACGCAAACTTCGTCTACACCACTACAG|AAACACTCATACTGAACTTAGCGACACTGC
GCAGAACGGGGTCTTGCCTCCTCCTTGTCT|ACACGTCAAACTATTGTATTGACTTTTAGG
AAAAAACACTCGCGCCCTATTCAGCGGACG|CAGGGGTTGCGGGCCCTGGGCAGGCAAAAA
AACACTCCATACTTACAACACCTTGCAGAA|TAGCCCCTTTGTAGCGGCCTGCACACACGT
TACTTGCGGGCCCTGGGCAGGCAAAAAACA|GACAATCCTGACTGTTGCGGGCCCTGGGCA
TCTGCGGGCCCTGGGCAGGCAAAAAACACT|GCTTAAAAGGGCACGTATTGCGTTGCGGGC
AAAAACACTCCATACTTACAACACCTTGCA|AGTTAGCCCCTTTGTAGCGGCCTGCACACA
ACTCCGCTATACCATATTGCGGGCCCTGGG|AGATGACTCTAACGCAAACTTCGTCTACAC
TTGACGTGGACTTGCACCAACCTGACCTTC|GCGCTAAGCCGTCTCAGCATAAGGCGAGTC
TGCATGGCGCTAAGCCGTCTCAGCATAAGG|TACTCGAACAACGGTAATGTGGTACTTGCG
ACGGATCTCAGTCACCGGGTTAAAAGAAAT|GGGCAGGCAAAAAACACTCACTCCGGCGAA
AGTCCCGACGGTGAGCACCGTTTCCGGACC|CCCTGGGCAGGCAAAAAACACTCTCTTATA
AGGCAAAAAACACTCAAAGTTAGCCCCTTT|GCAGGCAAAAAACACTCGCGCCCTATTCAG
AGTCTGCAATCGAGTGAGTGAGAGCCTGGG|CGTAATCGACCTTGCGGGCCCTGGGCAGGC
CGGCGAATCCACTTAGCAATTCCCTCGCTG|GACTACACGAACCGGAATCCCTTGCTCGTT
GCACACACGTCAAACTATTGTATTGACTTT|CCCTGGCCCAACCTAAAGCCACGTACATTG
GGAAGTCGGAGTGCAAGCGTAAGACCCATC|CAAAAAACACTCGGCCCTGGGCAGGCAAAA
CATACCTACGAAAGTCTGCAATCGAGTGAG|GACGGAAGACCACGTAATCGACCTTGCGGG
GTGGAAGTCGGAGTGCAAGCGTAAGACCCA|GGCAAAAAACACTCGGCCCTGGGCAGGCAA
AAAACACTCGCGCCCTATTCAGCGGACGAG|GGGGTTGCGGGCCCTGGGCAGGCAAAAAAC
ATCTCAGTCACCGGGTTAAAAGAAATTAGG|AGGCAAAAAACACTCACTCCGGCGAATCCA
TGCGGGCCCTGGGCAGGCAAAAAACACTCC|GCAGGCAAAAAACACTCAAAGTTAGCCCCT
TATTGCGGGCCCTGGGCAGGCAAAAAACAC|CAAACTTCGTCTACACCACTACAGGGGTTG
CCTCCAGGCACGTGAAGACAGTGGTTGCGG|TAGGTTGACTACGGGTCGCTTGCTAGATTA
ACTTAGCAATTCCCTCGCTGGGATTAAAAT|ACCGGAATCCCTTGCTCGTTGCGGGCCCTG
CGAGTCCCGACGGTGAGCACCGTTTCCGGA|GGCCCTGGGCAGGCAAAAAACACTCTCTTA
TCACGAACGCAGGTTCCGTTAATAGGAATA|TTTTCCACCCAGTGGCATTCGGCATACCAT
AAATGTGAGATGACTCTAACGCAAACTTCG|CCCTGGGCAGGCAAAAAACACTCATACTGA
CTGCACACACGTCAAACTATTGTATTGACT|TTCCCTGGCCCAACCTAAAGCCACGTACAT
GAGCACCGTTTCCGGACCTCCAGGCACGTG|AAAAAACACTCTCTTATAGGTTGACTACGG
GAAATTAGGCTGACGGAAGACCACGTAATC|GCGAATCCACTTAGCAATTCCCTCGCTGGG
GCAAAAAACACTCTGCGGGCCCTGGGCAGG|TTCCATGGTACGCTTAAAAGGGCACGTATT
TGGAAGTCGGAGTGCAAGCGTAAGACCCAT|GCAAAAAACACTCGGCCCTGGGCAGGCAAA
GGGCCCTGGGCAGGCAAAAAACTTGCGGGC|CTTACAACACCTTGCAGAACGGGGTCTTGC
ATTAGGCTGACGGAAGACCACGTAATCGAC|AATCCACTTAGCAATTCCCTCGCTGGGATT
GGCAGGCAAAAAACACTCTCTTATAGGTTG|TGCGGGCCCTGGGCAGGCAAAAAACACTCC
CATTAGTAATGCGACTCATGCATCAAATGT|TGGGCTACCGGAGCTCCTTGCGGGCCCTGG
TCATGCATCAAATGTGAGATGACTCTAACG|CCTTGCGGGCCCTGGGCAGGCAAAAAACAC
TTGTATTGACTTTTAGGGTTCTAATGCAGT|GCCACGTACATTGCATTAGTAATGCGACTC
TGAGAGCCTGGGACAATCCTGACTGTTGCG|CCCTGGGCAGGCAAAAAACACTCACCCTTG
GGAATATGGGCTACCGGAGCTCCTTGCGGG|TACCATAGTTAGCTCTCCTGTCGGGCATTT
CTCAGCATAAGGCGAGTCCCGACGGTGAGC|GTGGTACTTGCGGGCCCTGGGCAGGCAAAA
AAAAAACACTCCCATAGAGTCTATCTTTAC|CGGTGCGGCATACCTACGAAAGTCTGCAAT
TCACTCCGGCGAATCCACTTAGCAATTCCC|ATCATTGACTACACGAACCGGAATCCCTTG
ACACTCGCGCCCTATTCAGCGGACGAGTTC|GTTGCGGGCCCTGGGCAGGCAAAAAACACT
GGCCCTGGGCAGGCAAAAAACACTCAAAGT|CGGGCCCTGGGCAGGCAAAAAACACTCGCG
ATGACTCTAACGCAAACTTCGTCTACACCA|GGCAAAAAACACTCATACTGAACTTAGCGA
GCAGGCAAAAAACACTCGAAGCTGCATGGC|ACACTCCCATAGAGTCTATCTTTACTCGAA
TCCACTTAGCAATTCCCTCGCTGGGATTAA|CGAACCGGAATCCCTTGCTCGTTGCGGGCC
AAACACTCTGCGGGCCCTGGGCAGGCAAAA|TGGTACGCTTAAAAGGGCACGTATTGCGTT
GCCCTGGGCAGGCAAAAAACACTCACTCCG|GCCTCCTCCTTGTCTCATGACAATCATTGA
CGGGCCCTGGGCAGGCAAAAAACACTCCCA|TTACTCTCTCCTCACACGGTGCGGCATACC
ACCGGAGCTCCTTGCGGGCCCTGGGCAGGC|CTCTCCTGTCGGGCATTTAAACTGTATACC
TGCAATCGAGTGAGTGAGAGCCTGGGACAA|ATCGACCTTGCGGGCCCTGGGCAGGCAAAA
ACAGGGGTTGCGGGCCCTGGGCAGGCAAAA|CTGCCCACCATGGATGAATTAGCGCCACAT
AGGCAAAAAACACTCTGCGGGCCCTGGGCA|CTTTCCATGGTACGCTTAAAAGGGCACGTA
CTGGGCAGGCAAAAAACACTCTGATGTGGT|GCACGTATTGCGTTGCGGGCCCTGGGCAGG
AGGTTCCGTTAATAGGAATATGGGCTACCG|AGTGGCATTCGGCATACCATAGTTAGCTCT
GGCAGGCAAAAAACACTCGAAGCTGCATGG|AACACTCCCATAGAGTCTATCTTTACTCGA
GTGGTACTTGCGGGCCCTGGGCAGGCAAAA|CTGGGACAATCCTGACTGTTGCGGGCCCTG
GGCAAAAAACACTCCTTTACGGCACGGATC|CAGGCAAAAAACTTGCGGGCCCTGGGCAGG
ACTACACGAACCGGAATCCCTTGCTCGTTG|CAGGCACCACCTAACTCCGCTATACCATAT
CCCTGGGCAGGCAAAAAACACTCGCGCCCT|TCTACACCACTACAGGGGTTGCGGGCCCTG
TTTACTCGAACAACGGTAATGTGGTACTTG|GCAATCGAGTGAGTGAGAGCCTGGGACAAT
AACACTCGGCCCTGGGCAGGCAAAAAACAC|CTGGGCAGGCAAAAAACACTCCCATAGAGT
GCAGGCAAAAAACACTCACGAACGCAGGTT|AGCGCCACATCCTATTTTTCCACCCAGTGG
GGCCCTGGGCAGGCAAAAAACTTGCGGGCC|TTACAACACCTTGCAGAACGGGGTCTTGCC
GGGCCCTGGGCAGGCAAAAAACACTCTCTT|CTGACTGTTGCGGGCCCTGGGCAGGCAAAA
ACTTGCGGGCCCTGGGCAGGCAAAAAACAC|GGGGTCTTGCCTCCTCCTTGTCTCATGACA
TTGCGGGCCCTGGGCAGGCAAAAAACACTC|CACCAACCTGACCTTCTTTCCATGGTACGC
GAGTCCCGACGGTGAGCACCGTTTCCGGAC|GCCCTGGGCAGGCAAAAAACACTCTCTTAT
AGGCAAAAAACACTCACCCTTGCGGGCCCT|GGGCAGGCAAAAAACACTCCATACTTACAA
AATCGACCTTGCGGGCCCTGGGCAGGCAAA|TGGGATTAAAATTTGCGGGCCCTGGGCAGG
GGCAGGCAAAAAACACTCCCATAGAGTCTA|CCTCACACGGTGCGGCATACCTACGAAAGT
CGGGTTAAAAGAAATTAGGCTGACGGAAGA|ACTCACTCCGGCGAATCCACTTAGCAATTC
TTCCATGGTACGCTTAAAAGGGCACGTATT|CGACGGTGAGCACCGTTTCCGGACCTCCAG
AGGCAAAAAACACTCGCGCCCTATTCAGCG|ACTACAGGGGTTGCGGGCCCTGGGCAGGCA
CTAAGCCGTCTCAGCATAAGGCGAGTCCCG|AACGGTAATGTGGTACTTGCGGGCCCTGGG
TGGGCAGGCAAAAAACACTCGAAGCTGCAT|AAAACACTCCCATAGAGTCTATCTTTACTC
CTTGCGGGCCCTGGGCAGGCAAAAAACACT|GGGTCTTGCCTCCTCCTTGTCTCATGACAA
CTTGCAGAACGGGGTCTTGCCTCCTCCTTG|CACACACGTCAAACTATTGTATTGACTTTT
GTCCCGACGGTGAGCACCGTTTCCGGACCT|CCTGGGCAGGCAAAAAACACTCTCTTATAG
GCCCCTTTGTAGCGGCCTGCACACACGTCA|CTATTCAGCGGACGAGTTCCCTGGCCCAAC
TCGTCTACACCACTACAGGGGTTGCGGGCC|TGAACTTAGCGACACTGCCCACCATGGATG
AGTTCCCTGGCCCAACCTAAAGCCACGTAC|ACACTCACGAACGCAGGTTCCGTTAATAGG
CGGGCCCTGGGCAGGCAAAAAACACTCAAA|TGCGGGCCCTGGGCAGGCAAAAAACACTCG
ATCCTGACTGTTGCGGGCCCTGGGCAGGCA|AAACACTCACCCTTGCGGGCCCTGGGCAGG
ACACTCGGCCCTGGGCAGGCAAAAAACACT|TGGGCAGGCAAAAAACACTCCCATAGAGTC
GGCACGTATTGCGTTGCGGGCCCTGGGCAG|GGACCTCCAGGCACGTGAAGACAGTGGTTG
GTTAGCCCCTTTGTAGCGGCCTGCACACAC|CGCCCTATTCAGCGGACGAGTTCCCTGGCC
AGCATAAGGCGAGTCCCGACGGTGAGCACC|GTACTTGCGGGCCCTGGGCAGGCAAAAAAC
AAGTTAGCCCCTTTGTAGCGGCCTGCACAC|CGCGCCCTATTCAGCGGACGAGTTCCCTGG
CACCTTGCAGAACGGGGTCTTGCCTCCTCC|CTGCACACACGTCAAACTATTGTATTGACT
CAAAGTTAGCCCCTTTGTAGCGGCCTGCAC|CTCGCGCCCTATTCAGCGGACGAGTTCCCT
GAGTTCCCTGGCCCAACCTAAAGCCACGTA|AACACTCACGAACGCAGGTTCCGTTAATAG
ACCCTTGCGGGCCCTGGGCAGGCAAAAAAC|ACTCCATACTTACAACACCTTGCAGAACGG
CAACGGTAATGTGGTACTTGCGGGCCCTGG|GAGTGAGAGCCTGGGACAATCCTGACTGTT
GCCCTGGGCAGGCAAAAAACTTGCGGGCCC|TACAACACCTTGCAGAACGGGGTCTTGCCT
CATGGCGCTAAGCCGTCTCAGCATAAGGCG|CTCGAACAACGGTAATGTGGTACTTGCGGG
GGATTAAAATTTGCGGGCCCTGGGCAGGCA|GCGGGCCCTGGGCAGGCAAAAAACACTCAA
GGTTAAAAGAAATTAGGCTGACGGAAGACC|TCACTCCGGCGAATCCACTTAGCAATTCCC
ACACTCTGATGTGGTGGAAGTCGGAGTGCA|CGGGCCCTGGGCAGGCAAAAAACACTCGGC
AAAAAACACTCCTTTACGGCACGGATCTCA|GCAAAAAACTTGCGGGCCCTGGGCAGGCAA
GGTGCGGCATACCTACGAAAGTCTGCAATC|TTAGGCTGACGGAAGACCACGTAATCGACC
CGCAAACTTCGTCTACACCACTACAGGGGT|ACTCATACTGAACTTAGCGACACTGCCCAC
AAAGTCTGCAATCGAGTGAGTGAGAGCCTG|CACGTAATCGACCTTGCGGGCCCTGGGCAG
ACACTCTCTTATAGGTTGACTACGGGTCGC|GCAGGCAAAAAACACTCCTTTACGGCACGG
AAGACCCATCTGCTGCGTAAACCAGCTGTT|GCAGGCAAAAAACACTCGAAGCTGCATGGC
CGACGGTGAGCACCGTTTCCGGACCTCCAG|GGCAGGCAAAAAACACTCTCTTATAGGTTG
TTTGCGGGCCCTGGGCAGGCAAAAAACACT|GCACCAACCTGACCTTCTTTCCATGGTACG
AAACACTCCTTTACGGCACGGATCTCAGTC|AAAAACTTGCGGGCCCTGGGCAGGCAAAAA
GGCACGGATCTCAGTCACCGGGTTAAAAGA|CCTGGGCAGGCAAAAAACACTCACTCCGGC
GCGGACGAGTTCCCTGGCCCAACCTAAAGC|GCAAAAAACACTCACGAACGCAGGTTCCGT
CAAAAAACTTGCGGGCCCTGGGCAGGCAAA|CAGAACGGGGTCTTGCCTCCTCCTTGTCTC
AAAACACTCCATACTTACAACACCTTGCAG|GTTAGCCCCTTTGTAGCGGCCTGCACACAC
ACACTCCCATAGAGTCTATCTTTACTCGAA|CGGCATACCTACGAAAGTCTGCAATCGAGT
CACGTATTGCGTTGCGGGCCCTGGGCAGGC|ACCTCCAGGCACGTGAAGACAGTGGTTGCG
TTGACTTTTAGGGTTCTAATGCAGTCCAGG|GTACATTGCATTAGTAATGCGACTCATGCA
GCTCGTTGCGGGCCCTGGGCAGGCAAAAAA|TACCATATTGCGGGCCCTGGGCAGGCAAAA
TGAGTGAGAGCCTGGGACAATCCTGACTGT|CGGGCCCTGGGCAGGCAAAAAACACTCACC
TAAACCAGCTGTTGACGTGGACTTGCACCA|GAAGCTGCATGGCGCTAAGCCGTCTCAGCA
GCATTAGTAATGCGACTCATGCATCAAATG|ATGGGCTACCGGAGCTCCTTGCGGGCCCTG
CTCCTTGCGGGCCCTGGGCAGGCAAAAAAC|GTCGGGCATTTAAACTGTATACCGCGTACA
CCACTTAGCAATTCCCTCGCTGGGATTAAA|GAACCGGAATCCCTTGCTCGTTGCGGGCCC
GTCTCAGCATAAGGCGAGTCCCGACGGTGA|ATGTGGTACTTGCGGGCCCTGGGCAGGCAA
GCAGGCAAAAAACACTCACTCCGGCGAATC|CCTTGTCTCATGACAATCATTGACTACACG
ACGGCACGGATCTCAGTCACCGGGTTAAAA|GCCCTGGGCAGGCAAAAAACACTCACTCCG
TTCCTATTCATGTTTTGCGGGCCCTGGGCA|TTGACGTGGACTTGCACCAACCTGACCTTC
GGCAGGCAAAAAACACTCCTTTACGGCACG|TGGGCAGGCAAAAAACTTGCGGGCCCTGGG
GGGCAGGCAAAAAACACTCCTTTACGGCAC|CTGGGCAGGCAAAAAACTTGCGGGCCCTGG
TGCTCGTTGCGGGCCCTGGGCAGGCAAAAA|ATACCATATTGCGGGCCCTGGGCAGGCAAA
CTTGTCTCATGACAATCATTGACTACACGA|TTTTAGGGTTCTAATGCAGTCCAGGCACCA
ACAATCATTGACTACACGAACCGGAATCCC|TAATGCAGTCCAGGCACCACCTAACTCCGC
GGCAAAAAACACTCGAAGCTGCATGGCGCT|CTCCCATAGAGTCTATCTTTACTCGAACAA
TGACTCTAACGCAAACTTCGTCTACACCAC|GCAAAAAACACTCATACTGAACTTAGCGAC
AGGCGAGTCCCGACGGTGAGCACCGTTTCC|GCGGGCCCTGGGCAGGCAAAAAACACTCTC
CTGGGCAGGCAAAAAACACTCCCATAGAGT|TCTCCTCACACGGTGCGGCATACCTACGAA
CGTTTCCGGACCTCCAGGCACGTGAAGACA|CACTCTCTTATAGGTTGACTACGGGTCGCT
TGCACACACGTCAAACTATTGTATTGACTT|TCCCTGGCCCAACCTAAAGCCACGTACATT
AAAAAACACTCGGCCCTGGGCAGGCAAAAA|GGCCCTGGGCAGGCAAAAAACACTCCCATA
TCGCGCCCTATTCAGCGGACGAGTTCCCTG|CGGGCCCTGGGCAGGCAAAAAACACTCACG
TGGCCCAACCTAAAGCCACGTACATTGCAT|CGAACGCAGGTTCCGTTAATAGGAATATGG
ACCATATTGCGGGCCCTGGGCAGGCAAAAA|AACGCAAACTTCGTCTACACCACTACAGGG
GGCAAAAAACACTCTGATGTGGTGGAAGTC|TTGCGTTGCGGGCCCTGGGCAGGCAAAAAA
AACACCTTGCAGAACGGGGTCTTGCCTCCT|GCCTGCACACACGTCAAACTATTGTATTGA
AAAATTTGCGGGCCCTGGGCAGGCAAAAAA|CCCTGGGCAGGCAAAAAACACTCAAAGTTA
GTTAATAGGAATATGGGCTACCGGAGCTCC|TTCGGCATACCATAGTTAGCTCTCCTGTCG
ATTGCGTTGCGGGCCCTGGGCAGGCAAAAA|CAGGCACGTGAAGACAGTGGTTGCGGGCCC
CAGGCAAAAAACACTCACTCCGGCGAATCC|CTTGTCTCATGACAATCATTGACTACACGA
GGCCCAACCTAAAGCCACGTACATTGCATT|GAACGCAGGTTCCGTTAATAGGAATATGGG
CCTTTACGGCACGGATCTCAGTCACCGGGT|TGCGGGCCCTGGGCAGGCAAAAAACACTCA
GGTTCCGTTAATAGGAATATGGGCTACCGG|GTGGCATTCGGCATACCATAGTTAGCTCTC
GCAAAAAACACTCGCGCCCTATTCAGCGGA|TACAGGGGTTGCGGGCCCTGGGCAGGCAAA
TTAGTAATGCGACTCATGCATCAAATGTGA|GGCTACCGGAGCTCCTTGCGGGCCCTGGGC
CAGGCAAAAAACACTCACGAACGCAGGTTC|GCGCCACATCCTATTTTTCCACCCAGTGGC
AACGGTAATGTGGTACTTGCGGGCCCTGGG|AGTGAGAGCCTGGGACAATCCTGACTGTTG
TACTCGAACAACGGTAATGTGGTACTTGCG|AATCGAGTGAGTGAGAGCCTGGGACAATCC
AGGCACGTGAAGACAGTGGTTGCGGGCCCT|TGACTACGGGTCGCTTGCTAGATTACTCTC
TGGGCAGGCAAAAAACACTCCTTTACGGCA|CCTGGGCAGGCAAAAAACTTGCGGGCCCTG
AGGCAAAAAACACTCACGAACGCAGGTTCC|CGCCACATCCTATTTTTCCACCCAGTGGCA
GTGAAGACAGTGGTTGCGGGCCCTGGGCAG|CGGGTCGCTTGCTAGATTACTCTCTCCTCA
TCCAGGCACGTGAAGACAGTGGTTGCGGGC|GGTTGACTACGGGTCGCTTGCTAGATTACT
CATAAGGCGAGTCCCGACGGTGAGCACCGT|ACTTGCGGGCCCTGGGCAGGCAAAAAACAC
ACCTCCAGGCACGTGAAGACAGTGGTTGCG|ATAGGTTGACTACGGGTCGCTTGCTAGATT
GGCCCTGGGCAGGCAAAAAACACTCTGCGG|ACCTGACCTTCTTTCCATGGTACGCTTAAA
AAACTTGCGGGCCCTGGGCAGGCAAAAAAC|ACGGGGTCTTGCCTCCTCCTTGTCTCATGA
GAATCCACTTAGCAATTCCCTCGCTGGGAT|ACACGAACCGGAATCCCTTGCTCGTTGCGG
TTAGCCCCTTTGTAGCGGCCTGCACACACG|GCCCTATTCAGCGGACGAGTTCCCTGGCCC
CGTACATTGCATTAGTAATGCGACTCATGC|ATAGGAATATGGGCTACCGGAGCTCCTTGC
GTGAGTGAGAGCCTGGGACAATCCTGACTG|GCGGGCCCTGGGCAGGCAAAAAACACTCAC
GTGAGATGACTCTAACGCAAACTTCGTCTA|GGGCAGGCAAAAAACACTCATACTGAACTT
CCGGACCTCCAGGCACGTGAAGACAGTGGT|TCTTATAGGTTGACTACGGGTCGCTTGCTA
AGGCACCACCTAACTCCGCTATACCATATT|GCATCAAATGTGAGATGACTCTAACGCAAA
CGGGGTCTTGCCTCCTCCTTGTCTCATGAC|CAAACTATTGTATTGACTTTTAGGGTTCTA
CCCATCTGCTGCGTAAACCAGCTGTTGACG|GCAAAAAACACTCGAAGCTGCATGGCGCTA
GGGCAGGCAAAAAACACTCCCATAGAGTCT|TCCTCACACGGTGCGGCATACCTACGAAAG
GCAGGCAAAAAACACTCTGATGTGGTGGAA|GTATTGCGTTGCGGGCCCTGGGCAGGCAAA
GGTCGCTTGCTAGATTACTCTCTCCTCACA|GCACGGATCTCAGTCACCGGGTTAAAAGAA
CCCTGGGCAGGCAAAAAACACTCACGAACG|TGAATTAGCGCCACATCCTATTTTTCCACC
TTCCCTCGCTGGGATTAAAATTTGCGGGCC|CCTTGCTCGTTGCGGGCCCTGGGCAGGCAA
TTAAAATTTGCGGGCCCTGGGCAGGCAAAA|GGCCCTGGGCAGGCAAAAAACACTCAAAGT
CAAAAAACACTCTCTTATAGGTTGACTACG|CCCTGGGCAGGCAAAAAACACTCCTTTACG
AAGCCACGTACATTGCATTAGTAATGCGAC|CCGTTAATAGGAATATGGGCTACCGGAGCT
GCGGGCCCTGGGCAGGCAAAAAACACTCCC|ATTACTCTCTCCTCACACGGTGCGGCATAC
TCACACGGTGCGGCATACCTACGAAAGTCT|AAGAAATTAGGCTGACGGAAGACCACGTAA
ACCGGGTTAAAAGAAATTAGGCTGACGGAA|ACACTCACTCCGGCGAATCCACTTAGCAAT
CACGAACGCAGGTTCCGTTAATAGGAATAT|TTTCCACCCAGTGGCATTCGGCATACCATA
CAAAAAACACTCGCGCCCTATTCAGCGGAC|ACAGGGGTTGCGGGCCCTGGGCAGGCAAAA
GCATCAAATGTGAGATGACTCTAACGCAAA|GCGGGCCCTGGGCAGGCAAAAAACACTCAT
CAAAAAACACTCACGAACGCAGGTTCCGTT|CACATCCTATTTTTCCACCCAGTGGCATTC
ACTTTTAGGGTTCTAATGCAGTCCAGGCAC|CATTGCATTAGTAATGCGACTCATGCATCA
GACGAGTTCCCTGGCCCAACCTAAAGCCAC|AAAAACACTCACGAACGCAGGTTCCGTTAA
GAGCTCCTTGCGGGCCCTGGGCAGGCAAAA|CCTGTCGGGCATTTAAACTGTATACCGCGT
TCAGCATAAGGCGAGTCCCGACGGTGAGCA|TGGTACTTGCGGGCCCTGGGCAGGCAAAAA
GGGATTAAAATTTGCGGGCCCTGGGCAGGC|TGCGGGCCCTGGGCAGGCAAAAAACACTCA
GAGTGCAAGCGTAAGACCCATCTGCTGCGT|ACTCGGCCCTGGGCAGGCAAAAAACACTCG
CGCTTGCTAGATTACTCTCTCCTCACACGG|CGGATCTCAGTCACCGGGTTAAAAGAAATT
GGCAAAAAACACTCCATACTTACAACACCT|TCAAAGTTAGCCCCTTTGTAGCGGCCTGCA
TGTCTCATGACAATCATTGACTACACGAAC|TTAGGGTTCTAATGCAGTCCAGGCACCACC
GCAGGCAAAAAACTTGCGGGCCCTGGGCAG|CCTTGCAGAACGGGGTCTTGCCTCCTCCTT
CACCACCTAACTCCGCTATACCATATTGCG|TCAAATGTGAGATGACTCTAACGCAAACTT
CCCTCGCTGGGATTAAAATTTGCGGGCCCT|TTGCTCGTTGCGGGCCCTGGGCAGGCAAAA
GCCCTGGGCAGGCAAAAAACACTCACCCTT|GCGGGCCCTGGGCAGGCAAAAAACACTCCA
TCGAAGCTGCATGGCGCTAAGCCGTCTCAG|CTATCTTTACTCGAACAACGGTAATGTGGT
TCACCGGGTTAAAAGAAATTAGGCTGACGG|AAACACTCACTCCGGCGAATCCACTTAGCA
GGCCCTGGGCAGGCAAAAAACACTCACCCT|TGCGGGCCCTGGGCAGGCAAAAAACACTCC
CGAGTGAGTGAGAGCCTGGGACAATCCTGA|CTTGCGGGCCCTGGGCAGGCAAAAAACACT
AAAACACTCACGAACGCAGGTTCCGTTAAT|ATCCTATTTTTCCACCCAGTGGCATTCGGC
AGGCAAAAAACACTCTGATGTGGTGGAAGT|ATTGCGTTGCGGGCCCTGGGCAGGCAAAAA
CATTGCATTAGTAATGCGACTCATGCATCA|GAATATGGGCTACCGGAGCTCCTTGCGGGC
CACGGTGCGGCATACCTACGAAAGTCTGCA|AAATTAGGCTGACGGAAGACCACGTAATCG
ACTCCGGCGAATCCACTTAGCAATTCCCTC|CATTGACTACACGAACCGGAATCCCTTGCT
TGCGGCATACCTACGAAAGTCTGCAATCGA|AGGCTGACGGAAGACCACGTAATCGACCTT
AAGCGTAAGACCCATCTGCTGCGTAAACCA|CCCTGGGCAGGCAAAAAACACTCGAAGCTG
GCAGGTTCCGTTAATAGGAATATGGGCTAC|CCAGTGGCATTCGGCATACCATAGTTAGCT
CGCGCCCTATTCAGCGGACGAGTTCCCTGG|GGGCCCTGGGCAGGCAAAAAACACTCACGA
AAGCTGCATGGCGCTAAGCCGTCTCAGCAT|TCTTTACTCGAACAACGGTAATGTGGTACT
TTCTTTCCATGGTACGCTTAAAAGGGCACG|GTCCCGACGGTGAGCACCGTTTCCGGACCT
AAAAACACTCTGCGGGCCCTGGGCAGGCAA|CATGGTACGCTTAAAAGGGCACGTATTGCG
TTGCGGGCCCTGGGCAGGCAAAAAACACTC|GGCAGGCAAAAAACACTCAAAGTTAGCCCC
TTGACTACGGGTCGCTTGCTAGATTACTCT|TCCTTTACGGCACGGATCTCAGTCACCGGG
TCCATACTTACAACACCTTGCAGAACGGGG|CCTTTGTAGCGGCCTGCACACACGTCAAAC
ATAGGAATATGGGCTACCGGAGCTCCTTGC|GCATACCATAGTTAGCTCTCCTGTCGGGCA
CCTCCTTGTCTCATGACAATCATTGACTAC|TGACTTTTAGGGTTCTAATGCAGTCCAGGC
TGCATTAGTAATGCGACTCATGCATCAAAT|TATGGGCTACCGGAGCTCCTTGCGGGCCCT
TCTGATGTGGTGGAAGTCGGAGTGCAAGCG|CCCTGGGCAGGCAAAAAACACTCGGCCCTG
TTGCGGGCCCTGGGCAGGCAAAAAACACTC|AAATTTGCGGGCCCTGGGCAGGCAAAAAAC
TCTATCTTTACTCGAACAACGGTAATGTGG|AAGTCTGCAATCGAGTGAGTGAGAGCCTGG
TCTTTCCATGGTACGCTTAAAAGGGCACGT|TCCCGACGGTGAGCACCGTTTCCGGACCTC
GGGTTCTAATGCAGTCCAGGCACCACCTAA|TTAGTAATGCGACTCATGCATCAAATGTGA
GACAGTGGTTGCGGGCCCTGGGCAGGCAAA|CGCTTGCTAGATTACTCTCTCCTCACACGG
TGCGGGCCCTGGGCAGGCAAAAAACACTCT|ATCCTGACTGTTGCGGGCCCTGGGCAGGCA
ACTCGGCCCTGGGCAGGCAAAAAACACTCG|GGCAGGCAAAAAACACTCCCATAGAGTCTA
CAGTCCAGGCACCACCTAACTCCGCTATAC|ACTCATGCATCAAATGTGAGATGACTCTAA
AACTCCGCTATACCATATTGCGGGCCCTGG|GAGATGACTCTAACGCAAACTTCGTCTACA
AAACACTCACTCCGGCGAATCCACTTAGCA|ATGACAATCATTGACTACACGAACCGGAAT
ATATGGGCTACCGGAGCTCCTTGCGGGCCC|CATAGTTAGCTCTCCTGTCGGGCATTTAAA
GAACGGGGTCTTGCCTCCTCCTTGTCTCAT|CGTCAAACTATTGTATTGACTTTTAGGGTT
TAGCAATTCCCTCGCTGGGATTAAAATTTG|GGAATCCCTTGCTCGTTGCGGGCCCTGGGC
CTTGCTCGTTGCGGGCCCTGGGCAGGCAAA|CTATACCATATTGCGGGCCCTGGGCAGGCA
GGAAGACCACGTAATCGACCTTGCGGGCCC|CAATTCCCTCGCTGGGATTAAAATTTGCGG
TCTGCAATCGAGTGAGTGAGAGCCTGGGAC|TAATCGACCTTGCGGGCCCTGGGCAGGCAA
CCCTGGGCAGGCAAAAAACACTCCCATAGA|TCTCTCCTCACACGGTGCGGCATACCTACG
CTCGCTGGGATTAAAATTTGCGGGCCCTGG|GCTCGTTGCGGGCCCTGGGCAGGCAAAAAA
CCCAACCTAAAGCCACGTACATTGCATTAG|ACGCAGGTTCCGTTAATAGGAATATGGGCT
CAGCATAAGGCGAGTCCCGACGGTGAGCAC|GGTACTTGCGGGCCCTGGGCAGGCAAAAAA
TCGTGCTTCCTATTCATGTTTTGCGGGCCC|CAGCTGTTGACGTGGACTTGCACCAACCTG
GGCGAGTCCCGACGGTGAGCACCGTTTCCG|CGGGCCCTGGGCAGGCAAAAAACACTCTCT
CGAACGCAGGTTCCGTTAATAGGAATATGG|TCCACCCAGTGGCATTCGGCATACCATAGT
CACGAACCGGAATCCCTTGCTCGTTGCGGG|CACCACCTAACTCCGCTATACCATATTGCG
ACCTAAAGCCACGTACATTGCATTAGTAAT|AGGTTCCGTTAATAGGAATATGGGCTACCG
AGCGGACGAGTTCCCTGGCCCAACCTAAAG|GGCAAAAAACACTCACGAACGCAGGTTCCG
GATGACTCTAACGCAAACTTCGTCTACACC|AGGCAAAAAACACTCATACTGAACTTAGCG
AAGTCTGCAATCGAGTGAGTGAGAGCCTGG|ACGTAATCGACCTTGCGGGCCCTGGGCAGG
GCAAAAAACACTCGGCCCTGGGCAGGCAAA|CGGGCCCTGGGCAGGCAAAAAACACTCCCA
AAATTTGCGGGCCCTGGGCAGGCAAAAAAC|CCTGGGCAGGCAAAAAACACTCAAAGTTAG
CAAAAAACACTCGAAGCTGCATGGCGCTAA|CCCATAGAGTCTATCTTTACTCGAACAACG
ATAGGTTGACTACGGGTCGCTTGCTAGATT|AACACTCCTTTACGGCACGGATCTCAGTCA
AGAAATTAGGCTGACGGAAGACCACGTAAT|GGCGAATCCACTTAGCAATTCCCTCGCTGG
CAAAAAACACTCAAAGTTAGCCCCTTTGTA|GGCAAAAAACACTCGCGCCCTATTCAGCGG
ACTATTGTATTGACTTTTAGGGTTCTAATG|TAAAGCCACGTACATTGCATTAGTAATGCG
CCATATTGCGGGCCCTGGGCAGGCAAAAAA|ACGCAAACTTCGTCTACACCACTACAGGGG
ACAATCCTGACTGTTGCGGGCCCTGGGCAG|AAAAAACACTCACCCTTGCGGGCCCTGGGC
GCGAATCCACTTAGCAATTCCCTCGCTGGG|CTACACGAACCGGAATCCCTTGCTCGTTGC
ACCTTGCGGGCCCTGGGCAGGCAAAAAACA|TTAAAATTTGCGGGCCCTGGGCAGGCAAAA
CCACGTACATTGCATTAGTAATGCGACTCA|TTAATAGGAATATGGGCTACCGGAGCTCCT
TGCGTTGCGGGCCCTGGGCAGGCAAAAAAC|GGCACGTGAAGACAGTGGTTGCGGGCCCTG
GGGTCTTGCCTCCTCCTTGTCTCATGACAA|AACTATTGTATTGACTTTTAGGGTTCTAAT
GTTGACGTGGACTTGCACCAACCTGACCTT|GGCGCTAAGCCGTCTCAGCATAAGGCGAGT
GTTGCGGGCCCTGGGCAGGCAAAAAACACT|ACGTGAAGACAGTGGTTGCGGGCCCTGGGC
GTAATGCGACTCATGCATCAAATGTGAGAT|TACCGGAGCTCCTTGCGGGCCCTGGGCAGG
GGGCCCTGGGCAGGCAAAAAACACTCATAC|TTTAAACTGTATACCGCGTACAGTGTCTGA
CTCATGCATCAAATGTGAGATGACTCTAAC|TCCTTGCGGGCCCTGGGCAGGCAAAAAACA
AAAACACTCTGATGTGGTGGAAGTCGGAGT|TTGCGGGCCCTGGGCAGGCAAAAAACACTC
GGACGAGTTCCCTGGCCCAACCTAAAGCCA|AAAAAACACTCACGAACGCAGGTTCCGTTA
GCACGGATCTCAGTCACCGGGTTAAAAGAA|CTGGGCAGGCAAAAAACACTCACTCCGGCG
AATTCCCTCGCTGGGATTAAAATTTGCGGG|TCCCTTGCTCGTTGCGGGCCCTGGGCAGGC
AAACACTCCCATAGAGTCTATCTTTACTCG|TGCGGCATACCTACGAAAGTCTGCAATCGA
CTAACTCCGCTATACCATATTGCGGGCCCT|GTGAGATGACTCTAACGCAAACTTCGTCTA
TGTTGCGGGCCCTGGGCAGGCAAAAAACAC|ACCCTTGCGGGCCCTGGGCAGGCAAAAAAC
TAGTAATGCGACTCATGCATCAAATGTGAG|GCTACCGGAGCTCCTTGCGGGCCCTGGGCA
GGTTGCGGGCCCTGGGCAGGCAAAAAACAC|CTAGATTACTCTCTCCTCACACGGTGCGGC
CAGGCAAAAAACACTCAAAGTTAGCCCCTT|GGCAGGCAAAAAACACTCGCGCCCTATTCA
AACACTCACCCTTGCGGGCCCTGGGCAGGC|AAAAAACACTCCATACTTACAACACCTTGC
GGCAGGCAAAAAACACTCACGAACGCAGGT|TAGCGCCACATCCTATTTTTCCACCCAGTG
AGGCAAAAAACACTCGGCCCTGGGCAGGCA|TGCGGGCCCTGGGCAGGCAAAAAACACTCC
CGGGCCCTGGGCAGGCAAAAAACACTCGCG|TTCGTCTACACCACTACAGGGGTTGCGGGC
ACGCAGGTTCCGTTAATAGGAATATGGGCT|ACCCAGTGGCATTCGGCATACCATAGTTAG
AACACTCTCTTATAGGTTGACTACGGGTCG|GGCAGGCAAAAAACACTCCTTTACGGCACG
CACTCTGATGTGGTGGAAGTCGGAGTGCAA|GGGCCCTGGGCAGGCAAAAAACACTCGGCC
GGACTTGCACCAACCTGACCTTCTTTCCAT|GCCGTCTCAGCATAAGGCGAGTCCCGACGG
TGGGCAGGCAAAAAACACTCCCATAGAGTC|CTCCTCACACGGTGCGGCATACCTACGAAA
CACTCCTTTACGGCACGGATCTCAGTCACC|AACTTGCGGGCCCTGGGCAGGCAAAAAACA
GCAGGCAAAAAACACTCGCGCCCTATTCAG|CCACTACAGGGGTTGCGGGCCCTGGGCAGG
GACGTGGACTTGCACCAACCTGACCTTCTT|GCTAAGCCGTCTCAGCATAAGGCGAGTCCC
AAAAAACACTCACTCCGGCGAATCCACTTA|CTCATGACAATCATTGACTACACGAACCGG
CTCCATACTTACAACACCTTGCAGAACGGG|CCCTTTGTAGCGGCCTGCACACACGTCAAA
CATGACAATCATTGACTACACGAACCGGAA|GTTCTAATGCAGTCCAGGCACCACCTAACT
ATATTGCGGGCCCTGGGCAGGCAAAAAACA|GCAAACTTCGTCTACACCACTACAGGGGTT
GAAAGTCTGCAATCGAGTGAGTGAGAGCCT|CCACGTAATCGACCTTGCGGGCCCTGGGCA
GCCCAACCTAAAGCCACGTACATTGCATTA|AACGCAGGTTCCGTTAATAGGAATATGGGC
CGGATCTCAGTCACCGGGTTAAAAGAAATT|GGCAGGCAAAAAACACTCACTCCGGCGAAT
AAAACTTGCGGGCCCTGGGCAGGCAAAAAA|AACGGGGTCTTGCCTCCTCCTTGTCTCATG
AAAAACACTCGGCCCTGGGCAGGCAAAAAA|GCCCTGGGCAGGCAAAAAACACTCCCATAG
CAGGCACCACCTAACTCCGCTATACCATAT|TGCATCAAATGTGAGATGACTCTAACGCAA
CCCCTTTGTAGCGGCCTGCACACACGTCAA|TATTCAGCGGACGAGTTCCCTGGCCCAACC
TAATGTGGTACTTGCGGGCCCTGGGCAGGC|GAGCCTGGGACAATCCTGACTGTTGCGGGC
ACGTATTGCGTTGCGGGCCCTGGGCAGGCA|CCTCCAGGCACGTGAAGACAGTGGTTGCGG
GCTGGGATTAAAATTTGCGGGCCCTGGGCA|CGTTGCGGGCCCTGGGCAGGCAAAAAACAC
ACTACGGGTCGCTTGCTAGATTACTCTCTC|TTTACGGCACGGATCTCAGTCACCGGGTTA
TGTGGTGGAAGTCGGAGTGCAAGCGTAAGA|GGCAGGCAAAAAACACTCGGCCCTGGGCAG
ACGGGGTCTTGCCTCCTCCTTGTCTCATGA|TCAAACTATTGTATTGACTTTTAGGGTTCT
TGGGCAGGCAAAAAACACTCAAAGTTAGCC|CCTGGGCAGGCAAAAAACACTCGCGCCCTA
TGGGCAGGCAAAAAACACTCTGATGTGGTG|CACGTATTGCGTTGCGGGCCCTGGGCAGGC
AAAACACTCCCATAGAGTCTATCTTTACTC|GTGCGGCATACCTACGAAAGTCTGCAATCG
CACGTGAAGACAGTGGTTGCGGGCCCTGGG|CTACGGGTCGCTTGCTAGATTACTCTCTCC
ACGTCAAACTATTGTATTGACTTTTAGGGT|CCCAACCTAAAGCCACGTACATTGCATTAG
GGGCAGGCAAAAAACACTCAAAGTTAGCCC|CTGGGCAGGCAAAAAACACTCGCGCCCTAT
TCGGAGTGCAAGCGTAAGACCCATCTGCTG|AACACTCGGCCCTGGGCAGGCAAAAAACAC
TCCTTGTCTCATGACAATCATTGACTACAC|ACTTTTAGGGTTCTAATGCAGTCCAGGCAC
AACTATTGTATTGACTTTTAGGGTTCTAAT|CTAAAGCCACGTACATTGCATTAGTAATGC
TCCTGACTGTTGCGGGCCCTGGGCAGGCAA|AACACTCACCCTTGCGGGCCCTGGGCAGGC
ATGTGGTGGAAGTCGGAGTGCAAGCGTAAG|GGGCAGGCAAAAAACACTCGGCCCTGGGCA
GGATCTCAGTCACCGGGTTAAAAGAAATTA|GCAGGCAAAAAACACTCACTCCGGCGAATC
GACGGAAGACCACGTAATCGACCTTGCGGG|TAGCAATTCCCTCGCTGGGATTAAAATTTG
CCGTTTCCGGACCTCCAGGCACGTGAAGAC|ACACTCTCTTATAGGTTGACTACGGGTCGC
CAAACTATTGTATTGACTTTTAGGGTTCTA|ACCTAAAGCCACGTACATTGCATTAGTAAT
GTTAAAAGAAATTAGGCTGACGGAAGACCA|CACTCCGGCGAATCCACTTAGCAATTCCCT
CGGGCCCTGGGCAGGCAAAAAACACTCATA|ATTTAAACTGTATACCGCGTACAGTGTCTG
TACACCACTACAGGGGTTGCGGGCCCTGGG|TTAGCGACACTGCCCACCATGGATGAATTA
CATACTTACAACACCTTGCAGAACGGGGTC|TTTGTAGCGGCCTGCACACACGTCAAACTA
TCCTCACACGGTGCGGCATACCTACGAAAG|TAAAAGAAATTAGGCTGACGGAAGACCACG
AATCATTGACTACACGAACCGGAATCCCTT|ATGCAGTCCAGGCACCACCTAACTCCGCTA
CCATACTTACAACACCTTGCAGAACGGGGT|CTTTGTAGCGGCCTGCACACACGTCAAACT
AAACCAGCTGTTGACGTGGACTTGCACCAA|AAGCTGCATGGCGCTAAGCCGTCTCAGCAT
CTATACCATATTGCGGGCCCTGGGCAGGCA|CTCTAACGCAAACTTCGTCTACACCACTAC
CGGCCTGCACACACGTCAAACTATTGTATT|CGAGTTCCCTGGCCCAACCTAAAGCCACGT
GTATTGCGTTGCGGGCCCTGGGCAGGCAAA|TCCAGGCACGTGAAGACAGTGGTTGCGGGC
GCAAAAAACACTCAAAGTTAGCCCCTTTGT|AGGCAAAAAACACTCGCGCCCTATTCAGCG
CGAACCGGAATCCCTTGCTCGTTGCGGGCC|CCACCTAACTCCGCTATACCATATTGCGGG
AAACACTCGCGCCCTATTCAGCGGACGAGT|GGGTTGCGGGCCCTGGGCAGGCAAAAAACA
CGAAGCTGCATGGCGCTAAGCCGTCTCAGC|TATCTTTACTCGAACAACGGTAATGTGGTA
GTCGGAGTGCAAGCGTAAGACCCATCTGCT|AAACACTCGGCCCTGGGCAGGCAAAAAACA
CTGATGTGGTGGAAGTCGGAGTGCAAGCGT|CCTGGGCAGGCAAAAAACACTCGGCCCTGG
TCAGTCACCGGGTTAAAAGAAATTAGGCTG|CAAAAAACACTCACTCCGGCGAATCCACTT
AACACTCTGCGGGCCCTGGGCAGGCAAAAA|GGTACGCTTAAAAGGGCACGTATTGCGTTG
GGCAGGCAAAAAACACTCGCGCCCTATTCA|ACCACTACAGGGGTTGCGGGCCCTGGGCAG
TTTACGGCACGGATCTCAGTCACCGGGTTA|CGGGCCCTGGGCAGGCAAAAAACACTCACT
GGACAATCCTGACTGTTGCGGGCCCTGGGC|GCAAAAAACACTCACCCTTGCGGGCCCTGG
TCTTGCCTCCTCCTTGTCTCATGACAATCA|TATTGTATTGACTTTTAGGGTTCTAATGCA
AATTTGCGGGCCCTGGGCAGGCAAAAAACA|CTGGGCAGGCAAAAAACACTCAAAGTTAGC
CAGGGGTTGCGGGCCCTGGGCAGGCAAAAA|TGCCCACCATGGATGAATTAGCGCCACATC
TGACTGTTGCGGGCCCTGGGCAGGCAAAAA|ACTCACCCTTGCGGGCCCTGGGCAGGCAAA
ACTTACAACACCTTGCAGAACGGGGTCTTG|GTAGCGGCCTGCACACACGTCAAACTATTG
TTAAAAGAAATTAGGCTGACGGAAGACCAC|ACTCCGGCGAATCCACTTAGCAATTCCCTC
CTTTACGGCACGGATCTCAGTCACCGGGTT|GCGGGCCCTGGGCAGGCAAAAAACACTCAC
AGGGTTCTAATGCAGTCCAGGCACCACCTA|ATTAGTAATGCGACTCATGCATCAAATGTG
TGCTGCGTAAACCAGCTGTTGACGTGGACT|AACACTCGAAGCTGCATGGCGCTAAGCCGT
TACGAAAGTCTGCAATCGAGTGAGTGAGAG|AGACCACGTAATCGACCTTGCGGGCCCTGG
GGCCCTGGGCAGGCAAAAAACACTCACTCC|TGCCTCCTCCTTGTCTCATGACAATCATTG
TTCCCTGGCCCAACCTAAAGCCACGTACAT|ACTCACGAACGCAGGTTCCGTTAATAGGAA
CCAACCTGACCTTCTTTCCATGGTACGCTT|GCATAAGGCGAGTCCCGACGGTGAGCACCG
GGCCCTGGGCAGGCAAAAAACACTCGCGCC|CGTCTACACCACTACAGGGGTTGCGGGCCC
CTTGCGGGCCCTGGGCAGGCAAAAAACTTG|CCATACTTACAACACCTTGCAGAACGGGGT
GAGTCTATCTTTACTCGAACAACGGTAATG|CGAAAGTCTGCAATCGAGTGAGTGAGAGCC
TCCGTTAATAGGAATATGGGCTACCGGAGC|GCATTCGGCATACCATAGTTAGCTCTCCTG
GAAGACAGTGGTTGCGGGCCCTGGGCAGGC|GGTCGCTTGCTAGATTACTCTCTCCTCACA
CCTGGGCAGGCAAAAAACACTCCCATAGAG|CTCTCCTCACACGGTGCGGCATACCTACGA
GCGGGCCCTGGGCAGGCAAAAAACACTCAT|CATTTAAACTGTATACCGCGTACAGTGTCT
TCCAGGCACCACCTAACTCCGCTATACCAT|CATGCATCAAATGTGAGATGACTCTAACGC
CTCAGTCACCGGGTTAAAAGAAATTAGGCT|GCAAAAAACACTCACTCCGGCGAATCCACT
ACCGTTTCCGGACCTCCAGGCACGTGAAGA|AACACTCTCTTATAGGTTGACTACGGGTCG
AAAAGGGCACGTATTGCGTTGCGGGCCCTG|TTTCCGGACCTCCAGGCACGTGAAGACAGT
GCACGTATTGCGTTGCGGGCCCTGGGCAGG|GACCTCCAGGCACGTGAAGACAGTGGTTGC
CAATTCCCTCGCTGGGATTAAAATTTGCGG|ATCCCTTGCTCGTTGCGGGCCCTGGGCAGG
GGGCAGGCAAAAAACTTGCGGGCCCTGGGC|CACCTTGCAGAACGGGGTCTTGCCTCCTCC
GCCCTGGGCAGGCAAAAAACACTCTGATGT|AGGGCACGTATTGCGTTGCGGGCCCTGGGC
GATTAAAATTTGCGGGCCCTGGGCAGGCAA|CGGGCCCTGGGCAGGCAAAAAACACTCAAA
CCCTTTGTAGCGGCCTGCACACACGTCAAA|ATTCAGCGGACGAGTTCCCTGGCCCAACCT
AAACACTCACCCTTGCGGGCCCTGGGCAGG|CAAAAAACACTCCATACTTACAACACCTTG
GGCACCACCTAACTCCGCTATACCATATTG|CATCAAATGTGAGATGACTCTAACGCAAAC
CCCTGGGCAGGCAAAAAACACTCACTCCGG|CCTCCTCCTTGTCTCATGACAATCATTGAC
ACGCTTAAAAGGGCACGTATTGCGTTGCGG|GCACCGTTTCCGGACCTCCAGGCACGTGAA
CTAAAGCCACGTACATTGCATTAGTAATGC|GTTCCGTTAATAGGAATATGGGCTACCGGA
CAAAAAACACTCACTCCGGCGAATCCACTT|TCTCATGACAATCATTGACTACACGAACCG
GACAATCCTGACTGTTGCGGGCCCTGGGCA|CAAAAAACACTCACCCTTGCGGGCCCTGGG
CTCTGATGTGGTGGAAGTCGGAGTGCAAGC|GCCCTGGGCAGGCAAAAAACACTCGGCCCT
GGCACGTGAAGACAGTGGTTGCGGGCCCTG|GACTACGGGTCGCTTGCTAGATTACTCTCT
GACCTTCTTTCCATGGTACGCTTAAAAGGG|GCGAGTCCCGACGGTGAGCACCGTTTCCGG
CCTTGCAGAACGGGGTCTTGCCTCCTCCTT|GCACACACGTCAAACTATTGTATTGACTTT
CTCAAAGTTAGCCCCTTTGTAGCGGCCTGC|CACTCGCGCCCTATTCAGCGGACGAGTTCC
GCCTCCTCCTTGTCTCATGACAATCATTGA|GTATTGACTTTTAGGGTTCTAATGCAGTCC
CACCCTTGCGGGCCCTGGGCAGGCAAAAAA|CACTCCATACTTACAACACCTTGCAGAACG
CGTCAAACTATTGTATTGACTTTTAGGGTT|CCAACCTAAAGCCACGTACATTGCATTAGT
ATGCAGTCCAGGCACCACCTAACTCCGCTA|GCGACTCATGCATCAAATGTGAGATGACTC
ACTCGCGCCCTATTCAGCGGACGAGTTCCC|TGCGGGCCCTGGGCAGGCAAAAAACACTCA
TGGTACGCTTAAAAGGGCACGTATTGCGTT|GTGAGCACCGTTTCCGGACCTCCAGGCACG
TGGGATTAAAATTTGCGGGCCCTGGGCAGG|TTGCGGGCCCTGGGCAGGCAAAAAACACTC
CATCAAATGTGAGATGACTCTAACGCAAAC|CGGGCCCTGGGCAGGCAAAAAACACTCATA
AGGCAAAAAACACTCGAAGCTGCATGGCGC|ACTCCCATAGAGTCTATCTTTACTCGAACA
TTTTAGGGTTCTAATGCAGTCCAGGCACCA|TTGCATTAGTAATGCGACTCATGCATCAAA
GGTTCTAATGCAGTCCAGGCACCACCTAAC|TAGTAATGCGACTCATGCATCAAATGTGAG
GGCCCTGGGCAGGCAAAAAACACTCTCTTA|TGACTGTTGCGGGCCCTGGGCAGGCAAAAA
GTTTTGCGGGCCCTGGGCAGGCAAAAAACA|TTGCACCAACCTGACCTTCTTTCCATGGTA
AGTCTATCTTTACTCGAACAACGGTAATGT|GAAAGTCTGCAATCGAGTGAGTGAGAGCCT
ATGTTTTGCGGGCCCTGGGCAGGCAAAAAA|ACTTGCACCAACCTGACCTTCTTTCCATGG
AAGACAGTGGTTGCGGGCCCTGGGCAGGCA|GTCGCTTGCTAGATTACTCTCTCCTCACAC
GCAGGCAAAAAACACTCACCCTTGCGGGCC|CTGGGCAGGCAAAAAACACTCCATACTTAC
CTGGGCAGGCAAAAAACACTCGCGCCCTAT|TACACCACTACAGGGGTTGCGGGCCCTGGG
ACGAGTTCCCTGGCCCAACCTAAAGCCACG|AAAACACTCACGAACGCAGGTTCCGTTAAT
GACTACGGGTCGCTTGCTAGATTACTCTCT|CTTTACGGCACGGATCTCAGTCACCGGGTT
CGGCATACCTACGAAAGTCTGCAATCGAGT|GCTGACGGAAGACCACGTAATCGACCTTGC
CTTGCGGGCCCTGGGCAGGCAAAAAACACT|GGGCATTTAAACTGTATACCGCGTACAGTG
TCATGACAATCATTGACTACACGAACCGGA|GGTTCTAATGCAGTCCAGGCACCACCTAAC
AGGCTGACGGAAGACCACGTAATCGACCTT|CCACTTAGCAATTCCCTCGCTGGGATTAAA
CCGACGGTGAGCACCGTTTCCGGACCTCCA|GGGCAGGCAAAAAACACTCTCTTATAGGTT
GGGCCCTGGGCAGGCAAAAAACACTCCATA|GGCAAAAAACACTCAAAGTTAGCCCCTTTG
CCTGGGCAGGCAAAAAACACTCTGCGGGCC|TGACCTTCTTTCCATGGTACGCTTAAAAGG
TACCATATTGCGGGCCCTGGGCAGGCAAAA|TAACGCAAACTTCGTCTACACCACTACAGG
GTCTACACCACTACAGGGGTTGCGGGCCCT|AACTTAGCGACACTGCCCACCATGGATGAA
CACTCACTCCGGCGAATCCACTTAGCAATT|ACAATCATTGACTACACGAACCGGAATCCC
AGGCAAAAAACACTCTCTTATAGGTTGACT|GGGCCCTGGGCAGGCAAAAAACACTCCTTT
GACTTGCACCAACCTGACCTTCTTTCCATG|CCGTCTCAGCATAAGGCGAGTCCCGACGGT
CGGGCCCTGGGCAGGCAAAAAACACTCACC|TTTGCGGGCCCTGGGCAGGCAAAAAACACT
AAAAACACTCACTCCGGCGAATCCACTTAG|TCATGACAATCATTGACTACACGAACCGGA
GCTTGCACCATCGTGCTTCCTATTCATGTT|CTGCGTAAACCAGCTGTTGACGTGGACTTG
TGCGGGCCCTGGGCAGGCAAAAAACACTCT|TTAAAAGGGCACGTATTGCGTTGCGGGCCC
TGCACCAACCTGACCTTCTTTCCATGGTAC|CTCAGCATAAGGCGAGTCCCGACGGTGAGC
GTGAGCACCGTTTCCGGACCTCCAGGCACG|GCAAAAAACACTCTCTTATAGGTTGACTAC
CATCTGCTGCGTAAACCAGCTGTTGACGTG|AAAAAACACTCGAAGCTGCATGGCGCTAAG
TAGAGTCTATCTTTACTCGAACAACGGTAA|TACGAAAGTCTGCAATCGAGTGAGTGAGAG
TCTTATAGGTTGACTACGGGTCGCTTGCTA|AAAAAACACTCCTTTACGGCACGGATCTCA
GGGCCCTGGGCAGGCAAAAAACACTCTGCG|AACCTGACCTTCTTTCCATGGTACGCTTAA
CACTTAGCAATTCCCTCGCTGGGATTAAAA|AACCGGAATCCCTTGCTCGTTGCGGGCCCT
CCTGGGCAGGCAAAAAACACTCGGCCCTGG|CAGTGGTTGCGGGCCCTGGGCAGGCAAAAA
CTTTCCATGGTACGCTTAAAAGGGCACGTA|CCCGACGGTGAGCACCGTTTCCGGACCTCC
GGCAGGCAAAAAACACTCATACTGAACTTA|GTATACCGCGTACAGTGTCTGACACCGCGA
CTTACAACACCTTGCAGAACGGGGTCTTGC|TAGCGGCCTGCACACACGTCAAACTATTGT
CGGGCCCTGGGCAGGCAAAAAACACTCTCT|CCTGACTGTTGCGGGCCCTGGGCAGGCAAA
AGGGCACGTATTGCGTTGCGGGCCCTGGGC|CCGGACCTCCAGGCACGTGAAGACAGTGGT
CTTTACTCGAACAACGGTAATGTGGTACTT|TGCAATCGAGTGAGTGAGAGCCTGGGACAA
CACCAACCTGACCTTCTTTCCATGGTACGC|CAGCATAAGGCGAGTCCCGACGGTGAGCAC
CCAACCTAAAGCCACGTACATTGCATTAGT|CGCAGGTTCCGTTAATAGGAATATGGGCTA
CGAACAACGGTAATGTGGTACTTGCGGGCC|GAGTGAGTGAGAGCCTGGGACAATCCTGAC
GGTGGAAGTCGGAGTGCAAGCGTAAGACCC|AGGCAAAAAACACTCGGCCCTGGGCAGGCA
ACACGGTGCGGCATACCTACGAAAGTCTGC|GAAATTAGGCTGACGGAAGACCACGTAATC
TGACTTTTAGGGTTCTAATGCAGTCCAGGC|TACATTGCATTAGTAATGCGACTCATGCAT
CCTGACCTTCTTTCCATGGTACGCTTAAAA|AAGGCGAGTCCCGACGGTGAGCACCGTTTC
GCCCTGGGCAGGCAAAAAACACTCACGAAC|ATGAATTAGCGCCACATCCTATTTTTCCAC
TCGGCCCTGGGCAGGCAAAAAACACTCGAA|CAGGCAAAAAACACTCCCATAGAGTCTATC
CCTGGCCCAACCTAAAGCCACGTACATTGC|CACGAACGCAGGTTCCGTTAATAGGAATAT
GGCAAAAAACACTCGGCCCTGGGCAGGCAA|GCGGGCCCTGGGCAGGCAAAAAACACTCCC
CAGGCAAAAAACACTCGAAGCTGCATGGCG|CACTCCCATAGAGTCTATCTTTACTCGAAC
CCAGGCACCACCTAACTCCGCTATACCATA|ATGCATCAAATGTGAGATGACTCTAACGCA
GCAAAAAACACTCTCTTATAGGTTGACTAC|GCCCTGGGCAGGCAAAAAACACTCCTTTAC
CGGAGCTCCTTGCGGGCCCTGGGCAGGCAA|CTCCTGTCGGGCATTTAAACTGTATACCGC
GGCATACCTACGAAAGTCTGCAATCGAGTG|CTGACGGAAGACCACGTAATCGACCTTGCG
CAGGCAAAAAACACTCTCTTATAGGTTGAC|CGGGCCCTGGGCAGGCAAAAAACACTCCTT
GCTTAAAAGGGCACGTATTGCGTTGCGGGC|ACCGTTTCCGGACCTCCAGGCACGTGAAGA
TTTAGGGTTCTAATGCAGTCCAGGCACCAC|TGCATTAGTAATGCGACTCATGCATCAAAT
ACACTCGAAGCTGCATGGCGCTAAGCCGTC|GAGTCTATCTTTACTCGAACAACGGTAATG
TAACTCCGCTATACCATATTGCGGGCCCTG|TGAGATGACTCTAACGCAAACTTCGTCTAC
AAAGGGCACGTATTGCGTTGCGGGCCCTGG|TTCCGGACCTCCAGGCACGTGAAGACAGTG
GACCTCCAGGCACGTGAAGACAGTGGTTGC|TATAGGTTGACTACGGGTCGCTTGCTAGAT
CAATCATTGACTACACGAACCGGAATCCCT|AATGCAGTCCAGGCACCACCTAACTCCGCT
TAGGAATATGGGCTACCGGAGCTCCTTGCG|CATACCATAGTTAGCTCTCCTGTCGGGCAT
TGCGGGCCCTGGGCAGGCAAAAAACACTCA|AATTTGCGGGCCCTGGGCAGGCAAAAAACA
CGTAAGACCCATCTGCTGCGTAAACCAGCT|TGGGCAGGCAAAAAACACTCGAAGCTGCAT
CTCACACGGTGCGGCATACCTACGAAAGTC|AAAGAAATTAGGCTGACGGAAGACCACGTA
GGGACAATCCTGACTGTTGCGGGCCCTGGG|GGCAAAAAACACTCACCCTTGCGGGCCCTG
TACTCTCTCCTCACACGGTGCGGCATACCT|ACCGGGTTAAAAGAAATTAGGCTGACGGAA
GCTATACCATATTGCGGGCCCTGGGCAGGC|ACTCTAACGCAAACTTCGTCTACACCACTA
ACCTAACTCCGCTATACCATATTGCGGGCC|ATGTGAGATGACTCTAACGCAAACTTCGTC
ATGGGCTACCGGAGCTCCTTGCGGGCCCTG|TAGTTAGCTCTCCTGTCGGGCATTTAAACT
ACAACGGTAATGTGGTACTTGCGGGCCCTG|TGAGTGAGAGCCTGGGACAATCCTGACTGT
GCGGGCCCTGGGCAGGCAAAAAACACTCCT|TTGCGGGCCCTGGGCAGGCAAAAAACTTGC
GCACCGTTTCCGGACCTCCAGGCACGTGAA|AAAACACTCTCTTATAGGTTGACTACGGGT
AAACTATTGTATTGACTTTTAGGGTTCTAA|CCTAAAGCCACGTACATTGCATTAGTAATG
AACAACGGTAATGTGGTACTTGCGGGCCCT|GTGAGTGAGAGCCTGGGACAATCCTGACTG
TACAGGGGTTGCGGGCCCTGGGCAGGCAAA|ACTGCCCACCATGGATGAATTAGCGCCACA
ATTACTCTCTCCTCACACGGTGCGGCATAC|TCACCGGGTTAAAAGAAATTAGGCTGACGG
GGAGTGCAAGCGTAAGACCCATCTGCTGCG|CACTCGGCCCTGGGCAGGCAAAAAACACTC
GTCTCATGACAATCATTGACTACACGAACC|TAGGGTTCTAATGCAGTCCAGGCACCACCT
AAGACCACGTAATCGACCTTGCGGGCCCTG|ATTCCCTCGCTGGGATTAAAATTTGCGGGC
CCTAACTCCGCTATACCATATTGCGGGCCC|TGTGAGATGACTCTAACGCAAACTTCGTCT
GCAGGCAAAAAACACTCAAAGTTAGCCCCT|GGGCAGGCAAAAAACACTCGCGCCCTATTC
CAGCTGTTGACGTGGACTTGCACCAACCTG|TGCATGGCGCTAAGCCGTCTCAGCATAAGG
CACTCCGGCGAATCCACTTAGCAATTCCCT|TCATTGACTACACGAACCGGAATCCCTTGC
CTCCTTTACGGCACGGATCTCAGTCACCGG|CTTGCGGGCCCTGGGCAGGCAAAAAACACT
AGACAGTGGTTGCGGGCCCTGGGCAGGCAA|TCGCTTGCTAGATTACTCTCTCCTCACACG
CACGTAATCGACCTTGCGGGCCCTGGGCAG|CTCGCTGGGATTAAAATTTGCGGGCCCTGG
AAAACACTCACTCCGGCGAATCCACTTAGC|CATGACAATCATTGACTACACGAACCGGAA
CCCTGGGCAGGCAAAAAACACTCTCTTATA|ACTGTTGCGGGCCCTGGGCAGGCAAAAAAC
CGGGCCCTGGGCAGGCAAAAAACACTCCAT|AGGCAAAAAACACTCAAAGTTAGCCCCTTT
GCAGGCAAAAAACACTCTGCGGGCCCTGGG|TTCTTTCCATGGTACGCTTAAAAGGGCACG
ACACACGTCAAACTATTGTATTGACTTTTA|CTGGCCCAACCTAAAGCCACGTACATTGCA
GCCCTGGGCAGGCAAAAAACACTCGGCCCT|GACAGTGGTTGCGGGCCCTGGGCAGGCAAA
TGGGCAGGCAAAAAACACTCCATACTTACA|AAACACTCAAAGTTAGCCCCTTTGTAGCGG
CCCTTGCGGGCCCTGGGCAGGCAAAAAACT|CTCCATACTTACAACACCTTGCAGAACGGG
CGGGCCCTGGGCAGGCAAAAAACACTCCTT|TGCGGGCCCTGGGCAGGCAAAAAACTTGCG
TTGCTAGATTACTCTCTCCTCACACGGTGC|ATCTCAGTCACCGGGTTAAAAGAAATTAGG
GCGTTGCGGGCCCTGGGCAGGCAAAAAACA|GCACGTGAAGACAGTGGTTGCGGGCCCTGG
CCTGCACACACGTCAAACTATTGTATTGAC|GTTCCCTGGCCCAACCTAAAGCCACGTACA
CCTCACACGGTGCGGCATACCTACGAAAGT|AAAAGAAATTAGGCTGACGGAAGACCACGT
AGACCCATCTGCTGCGTAAACCAGCTGTTG|CAGGCAAAAAACACTCGAAGCTGCATGGCG
AATCCTGACTGTTGCGGGCCCTGGGCAGGC|AAAACACTCACCCTTGCGGGCCCTGGGCAG
GTGCAAGCGTAAGACCCATCTGCTGCGTAA|TCGGCCCTGGGCAGGCAAAAAACACTCGAA
TTACTCGAACAACGGTAATGTGGTACTTGC|CAATCGAGTGAGTGAGAGCCTGGGACAATC
AAGTCGGAGTGCAAGCGTAAGACCCATCTG|AAAAACACTCGGCCCTGGGCAGGCAAAAAA
GGCAGGCAAAAAACACTCTGATGTGGTGGA|CGTATTGCGTTGCGGGCCCTGGGCAGGCAA
CCTGGGCAGGCAAAAAACACTCTCTTATAG|CTGTTGCGGGCCCTGGGCAGGCAAAAAACA
CATGGTACGCTTAAAAGGGCACGTATTGCG|CGGTGAGCACCGTTTCCGGACCTCCAGGCA
TCGTTGCGGGCCCTGGGCAGGCAAAAAACA|CCATATTGCGGGCCCTGGGCAGGCAAAAAA
CGAGTTCCCTGGCCCAACCTAAAGCCACGT|AAACACTCACGAACGCAGGTTCCGTTAATA
CCTCCTCCTTGTCTCATGACAATCATTGAC|TATTGACTTTTAGGGTTCTAATGCAGTCCA
CCCTGGGCAGGCAAAAAACACTCAAAGTTA|GGCCCTGGGCAGGCAAAAAACACTCGCGCC
GGCCCTGGGCAGGCAAAAAACACTCCTTTA|CGGGCCCTGGGCAGGCAAAAAACTTGCGGG
CGGTGCGGCATACCTACGAAAGTCTGCAAT|ATTAGGCTGACGGAAGACCACGTAATCGAC
CAATCGAGTGAGTGAGAGCCTGGGACAATC|CGACCTTGCGGGCCCTGGGCAGGCAAAAAA
TATAGGTTGACTACGGGTCGCTTGCTAGAT|AAACACTCCTTTACGGCACGGATCTCAGTC
GCGGGCCCTGGGCAGGCAAAAAACACTCTC|TCCTGACTGTTGCGGGCCCTGGGCAGGCAA
CTTATAGGTTGACTACGGGTCGCTTGCTAG|AAAAACACTCCTTTACGGCACGGATCTCAG
CAAAAAACACTCCATACTTACAACACCTTG|AAAGTTAGCCCCTTTGTAGCGGCCTGCACA
AAACACTCTCTTATAGGTTGACTACGGGTC|GGGCAGGCAAAAAACACTCCTTTACGGCAC
CAGGCAAAAAACACTCCATACTTACAACAC|ACTCAAAGTTAGCCCCTTTGTAGCGGCCTG
CCTTGCGGGCCCTGGGCAGGCAAAAAACAC|CGGGCATTTAAACTGTATACCGCGTACAGT
CTGCAATCGAGTGAGTGAGAGCCTGGGACA|AATCGACCTTGCGGGCCCTGGGCAGGCAAA
TGTTGACGTGGACTTGCACCAACCTGACCT|TGGCGCTAAGCCGTCTCAGCATAAGGCGAG
CGCTTAAAAGGGCACGTATTGCGTTGCGGG|CACCGTTTCCGGACCTCCAGGCACGTGAAG
TTGCGGGCCCTGGGCAGGCAAAAAACACTC|AATCCTGACTGTTGCGGGCCCTGGGCAGGC
GCAGGCAAAAAACACTCCTTTACGGCACGG|GGGCAGGCAAAAAACTTGCGGGCCCTGGGC
GTATTGACTTTTAGGGTTCTAATGCAGTCC|CACGTACATTGCATTAGTAATGCGACTCAT
CCCTGGGCAGGCAAAAAACACTCTGATGTG|GGGCACGTATTGCGTTGCGGGCCCTGGGCA
CAAAAAACACTCTGATGTGGTGGAAGTCGG|GCGTTGCGGGCCCTGGGCAGGCAAAAAACA
TACGGCACGGATCTCAGTCACCGGGTTAAA|GGCCCTGGGCAGGCAAAAAACACTCACTCC
GACTACACGAACCGGAATCCCTTGCTCGTT|CCAGGCACCACCTAACTCCGCTATACCATA
CTCCTTGTCTCATGACAATCATTGACTACA|GACTTTTAGGGTTCTAATGCAGTCCAGGCA
ATTGACTACACGAACCGGAATCCCTTGCTC|AGTCCAGGCACCACCTAACTCCGCTATACC
CTTGCGGGCCCTGGGCAGGCAAAAAACACT|CAATCCTGACTGTTGCGGGCCCTGGGCAGG
CGTCTACACCACTACAGGGGTTGCGGGCCC|GAACTTAGCGACACTGCCCACCATGGATGA
CCCTGGGCAGGCAAAAAACACTCGGCCCTG|ACAGTGGTTGCGGGCCCTGGGCAGGCAAAA
GGCAGGCAAAAAACACTCACTCCGGCGAAT|TCCTTGTCTCATGACAATCATTGACTACAC
GTACATTGCATTAGTAATGCGACTCATGCA|TAGGAATATGGGCTACCGGAGCTCCTTGCG
TGCAAGCGTAAGACCCATCTGCTGCGTAAA|CGGCCCTGGGCAGGCAAAAAACACTCGAAG
AACACTCTGATGTGGTGGAAGTCGGAGTGC|GCGGGCCCTGGGCAGGCAAAAAACACTCGG
TTACAACACCTTGCAGAACGGGGTCTTGCC|AGCGGCCTGCACACACGTCAAACTATTGTA
TGGACTTGCACCAACCTGACCTTCTTTCCA|AGCCGTCTCAGCATAAGGCGAGTCCCGACG
TTGCGGGCCCTGGGCAGGCAAAAAACACTC|CCTTGCGGGCCCTGGGCAGGCAAAAAACTT
GCCCTATTCAGCGGACGAGTTCCCTGGCCC|CCCTGGGCAGGCAAAAAACACTCACGAACG
GGCAAAAAACACTCACGAACGCAGGTTCCG|GCCACATCCTATTTTTCCACCCAGTGGCAT
AAAGTTAGCCCCTTTGTAGCGGCCTGCACA|TCGCGCCCTATTCAGCGGACGAGTTCCCTG
AACTTGCGGGCCCTGGGCAGGCAAAAAACA|CGGGGTCTTGCCTCCTCCTTGTCTCATGAC
TACAACACCTTGCAGAACGGGGTCTTGCCT|GCGGCCTGCACACACGTCAAACTATTGTAT
GACCCATCTGCTGCGTAAACCAGCTGTTGA|AGGCAAAAAACACTCGAAGCTGCATGGCGC
GAACGCAGGTTCCGTTAATAGGAATATGGG|CCACCCAGTGGCATTCGGCATACCATAGTT
GTGCTTCCTATTCATGTTTTGCGGGCCCTG|GCTGTTGACGTGGACTTGCACCAACCTGAC
GAGAGCCTGGGACAATCCTGACTGTTGCGG|CCTGGGCAGGCAAAAAACACTCACCCTTGC
ATGCATCAAATGTGAGATGACTCTAACGCA|TTGCGGGCCCTGGGCAGGCAAAAAACACTC
CCTATTCATGTTTTGCGGGCCCTGGGCAGG|GACGTGGACTTGCACCAACCTGACCTTCTT
AAAACACTCAAAGTTAGCCCCTTTGTAGCG|AAAAAACACTCGCGCCCTATTCAGCGGACG
CCCTGGGCAGGCAAAAAACACTCTGCGGGC|CTGACCTTCTTTCCATGGTACGCTTAAAAG
TGTGGTACTTGCGGGCCCTGGGCAGGCAAA|CCTGGGACAATCCTGACTGTTGCGGGCCCT
GCTAAGCCGTCTCAGCATAAGGCGAGTCCC|CAACGGTAATGTGGTACTTGCGGGCCCTGG
CGTTGCGGGCCCTGGGCAGGCAAAAAACAC|CATATTGCGGGCCCTGGGCAGGCAAAAAAC
AATCGAGTGAGTGAGAGCCTGGGACAATCC|GACCTTGCGGGCCCTGGGCAGGCAAAAAAC
CTGGGCAGGCAAAAAACACTCACCCTTGCG|GGCCCTGGGCAGGCAAAAAACACTCCATAC
GCGGGCCCTGGGCAGGCAAAAAACACTCAA|TTGCGGGCCCTGGGCAGGCAAAAAACACTC
CCACTACAGGGGTTGCGGGCCCTGGGCAGG|CGACACTGCCCACCATGGATGAATTAGCGC
AACGCAGGTTCCGTTAATAGGAATATGGGC|CACCCAGTGGCATTCGGCATACCATAGTTA
CCTATTCAGCGGACGAGTTCCCTGGCCCAA|CTGGGCAGGCAAAAAACACTCACGAACGCA
GACCTTGCGGGCCCTGGGCAGGCAAAAAAC|ATTAAAATTTGCGGGCCCTGGGCAGGCAAA
GGCTGACGGAAGACCACGTAATCGACCTTG|CACTTAGCAATTCCCTCGCTGGGATTAAAA
GGCCCTGGGCAGGCAAAAAACACTCGGCCC|AGACAGTGGTTGCGGGCCCTGGGCAGGCAA
CACCGGGTTAAAAGAAATTAGGCTGACGGA|AACACTCACTCCGGCGAATCCACTTAGCAA
CAAAAAACACTCACCCTTGCGGGCCCTGGG|CAGGCAAAAAACACTCCATACTTACAACAC
ATTAAAATTTGCGGGCCCTGGGCAGGCAAA|GGGCCCTGGGCAGGCAAAAAACACTCAAAG
GTTGCGGGCCCTGGGCAGGCAAAAAACACT|CCCTTGCGGGCCCTGGGCAGGCAAAAAACT
TATTGTATTGACTTTTAGGGTTCTAATGCA|AAGCCACGTACATTGCATTAGTAATGCGAC
TTGCGGGCCCTGGGCAGGCAAAAAACACTC|GGTCTTGCCTCCTCCTTGTCTCATGACAAT
ACACTCCTTTACGGCACGGATCTCAGTCAC|AAACTTGCGGGCCCTGGGCAGGCAAAAAAC
CAGAACGGGGTCTTGCCTCCTCCTTGTCTC|CACGTCAAACTATTGTATTGACTTTTAGGG
CTCTCTCCTCACACGGTGCGGCATACCTAC|CGGGTTAAAAGAAATTAGGCTGACGGAAGA
TGTGAGATGACTCTAACGCAAACTTCGTCT|TGGGCAGGCAAAAAACACTCATACTGAACT
GCCCTGGGCAGGCAAAAAACACTCGCGCCC|GTCTACACCACTACAGGGGTTGCGGGCCCT
GGCAGGCAAAAAACACTCGGCCCTGGGCAG|GGTTGCGGGCCCTGGGCAGGCAAAAAACAC
AACACTCGCGCCCTATTCAGCGGACGAGTT|GGTTGCGGGCCCTGGGCAGGCAAAAAACAC
AATCCCTTGCTCGTTGCGGGCCCTGGGCAG|CTCCGCTATACCATATTGCGGGCCCTGGGC
TATTGCGTTGCGGGCCCTGGGCAGGCAAAA|CCAGGCACGTGAAGACAGTGGTTGCGGGCC
AAGCCGTCTCAGCATAAGGCGAGTCCCGAC|CGGTAATGTGGTACTTGCGGGCCCTGGGCA
CTATTGTATTGACTTTTAGGGTTCTAATGC|AAAGCCACGTACATTGCATTAGTAATGCGA
CGGACGAGTTCCCTGGCCCAACCTAAAGCC|CAAAAAACACTCACGAACGCAGGTTCCGTT
TAATAGGAATATGGGCTACCGGAGCTCCTT|CGGCATACCATAGTTAGCTCTCCTGTCGGG
CTGTTGACGTGGACTTGCACCAACCTGACC|ATGGCGCTAAGCCGTCTCAGCATAAGGCGA
GCTAGATTACTCTCTCCTCACACGGTGCGG|CTCAGTCACCGGGTTAAAAGAAATTAGGCT
GTAAGACCCATCTGCTGCGTAAACCAGCTG|GGGCAGGCAAAAAACACTCGAAGCTGCATG
TCTCTTATAGGTTGACTACGGGTCGCTTGC|GCAAAAAACACTCCTTTACGGCACGGATCT
CACTCAAAGTTAGCCCCTTTGTAGCGGCCT|AACACTCGCGCCCTATTCAGCGGACGAGTT
CCTGGGCAGGCAAAAAACACTCTGATGTGG|GGCACGTATTGCGTTGCGGGCCCTGGGCAG
TTGCATTAGTAATGCGACTCATGCATCAAA|ATATGGGCTACCGGAGCTCCTTGCGGGCCC
CACCGTTTCCGGACCTCCAGGCACGTGAAG|AAACACTCTCTTATAGGTTGACTACGGGTC
GTAAACCAGCTGTTGACGTGGACTTGCACC|CGAAGCTGCATGGCGCTAAGCCGTCTCAGC
CCTTGCGGGCCCTGGGCAGGCAAAAAACTT|TCCATACTTACAACACCTTGCAGAACGGGG
AAAAACACTCACCCTTGCGGGCCCTGGGCA|GGCAAAAAACACTCCATACTTACAACACCT
CCCTGGCCCAACCTAAAGCCACGTACATTG|TCACGAACGCAGGTTCCGTTAATAGGAATA
CACTCACGAACGCAGGTTCCGTTAATAGGA|TATTTTTCCACCCAGTGGCATTCGGCATAC
GGCAGGCAAAAAACACTCTGCGGGCCCTGG|CTTCTTTCCATGGTACGCTTAAAAGGGCAC
TGGGCAGGCAAAAAACACTCACGAACGCAG|ATTAGCGCCACATCCTATTTTTCCACCCAG
CGGGCCCTGGGCAGGCAAAAAACACTCTGA|AAAAGGGCACGTATTGCGTTGCGGGCCCTG
TGCATCAAATGTGAGATGACTCTAACGCAA|TGCGGGCCCTGGGCAGGCAAAAAACACTCA
CAGGCAAAAAACACTCACCCTTGCGGGCCC|TGGGCAGGCAAAAAACACTCCATACTTACA
CCTGGGCAGGCAAAAAACACTCACCCTTGC|GGGCCCTGGGCAGGCAAAAAACACTCCATA
CCTGGGCAGGCAAAAAACACTCGAAGCTGC|AAAAAACACTCCCATAGAGTCTATCTTTAC
TCCTATTCATGTTTTGCGGGCCCTGGGCAG|TGACGTGGACTTGCACCAACCTGACCTTCT
ACCATCGTGCTTCCTATTCATGTTTTGCGG|AAACCAGCTGTTGACGTGGACTTGCACCAA
ATCATTGACTACACGAACCGGAATCCCTTG|TGCAGTCCAGGCACCACCTAACTCCGCTAT
GGGCAGGCAAAAAACACTCCATACTTACAA|AACACTCAAAGTTAGCCCCTTTGTAGCGGC
ACGGGTCGCTTGCTAGATTACTCTCTCCTC|ACGGCACGGATCTCAGTCACCGGGTTAAAA
CACGGATCTCAGTCACCGGGTTAAAAGAAA|TGGGCAGGCAAAAAACACTCACTCCGGCGA
GCTCCTTGCGGGCCCTGGGCAGGCAAAAAA|TGTCGGGCATTTAAACTGTATACCGCGTAC
GGGCCCTGGGCAGGCAAAAAACACTCCCAT|TACTCTCTCCTCACACGGTGCGGCATACCT
AAAAACACTCACGAACGCAGGTTCCGTTAA|CATCCTATTTTTCCACCCAGTGGCATTCGG
ATGCGACTCATGCATCAAATGTGAGATGAC|CGGAGCTCCTTGCGGGCCCTGGGCAGGCAA
ATCCACTTAGCAATTCCCTCGCTGGGATTA|ACGAACCGGAATCCCTTGCTCGTTGCGGGC
AGTTAGCCCCTTTGTAGCGGCCTGCACACA|GCGCCCTATTCAGCGGACGAGTTCCCTGGC
TAAAATTTGCGGGCCCTGGGCAGGCAAAAA|GCCCTGGGCAGGCAAAAAACACTCAAAGTT
TCCTTGCGGGCCCTGGGCAGGCAAAAAACA|TCGGGCATTTAAACTGTATACCGCGTACAG
GTTGACTACGGGTCGCTTGCTAGATTACTC|CTCCTTTACGGCACGGATCTCAGTCACCGG
AAAACACTCGAAGCTGCATGGCGCTAAGCC|ATAGAGTCTATCTTTACTCGAACAACGGTA
TATGGGCTACCGGAGCTCCTTGCGGGCCCT|ATAGTTAGCTCTCCTGTCGGGCATTTAAAC
CTCTGCGGGCCCTGGGCAGGCAAAAAACAC|CGCTTAAAAGGGCACGTATTGCGTTGCGGG
GTAATGTGGTACTTGCGGGCCCTGGGCAGG|AGAGCCTGGGACAATCCTGACTGTTGCGGG
ATGGTACGCTTAAAAGGGCACGTATTGCGT|GGTGAGCACCGTTTCCGGACCTCCAGGCAC
ACTCGAACAACGGTAATGTGGTACTTGCGG|ATCGAGTGAGTGAGAGCCTGGGACAATCCT
GGGCCCTGGGCAGGCAAAAAACACTCCTTT|GCGGGCCCTGGGCAGGCAAAAAACTTGCGG
ACGAAAGTCTGCAATCGAGTGAGTGAGAGC|GACCACGTAATCGACCTTGCGGGCCCTGGG
GTCACCGGGTTAAAAGAAATTAGGCTGACG|AAAACACTCACTCCGGCGAATCCACTTAGC
GCAAAAAACACTCCTTTACGGCACGGATCT|AGGCAAAAAACTTGCGGGCCCTGGGCAGGC
CTTTGTAGCGGCCTGCACACACGTCAAACT|TCAGCGGACGAGTTCCCTGGCCCAACCTAA
GCTGCGTAAACCAGCTGTTGACGTGGACTT|ACACTCGAAGCTGCATGGCGCTAAGCCGTC
CATAGAGTCTATCTTTACTCGAACAACGGT|CCTACGAAAGTCTGCAATCGAGTGAGTGAG
CGGAAGACCACGTAATCGACCTTGCGGGCC|GCAATTCCCTCGCTGGGATTAAAATTTGCG
CCAGCTGTTGACGTGGACTTGCACCAACCT|CTGCATGGCGCTAAGCCGTCTCAGCATAAG
AGATGACTCTAACGCAAACTTCGTCTACAC|CAGGCAAAAAACACTCATACTGAACTTAGC
GCGGGCCCTGGGCAGGCAAAAAACACTCGC|CTTCGTCTACACCACTACAGGGGTTGCGGG
TCAAATGTGAGATGACTCTAACGCAAACTT|GGCCCTGGGCAGGCAAAAAACACTCATACT
CTACCGGAGCTCCTTGCGGGCCCTGGGCAG|AGCTCTCCTGTCGGGCATTTAAACTGTATA
TGCGGGCCCTGGGCAGGCAAAAAACACTCG|ACTTCGTCTACACCACTACAGGGGTTGCGG
TCCCATAGAGTCTATCTTTACTCGAACAAC|ATACCTACGAAAGTCTGCAATCGAGTGAGT
CCCATAGAGTCTATCTTTACTCGAACAACG|TACCTACGAAAGTCTGCAATCGAGTGAGTG
GGCAGGCAAAAAACACTCCATACTTACAAC|ACACTCAAAGTTAGCCCCTTTGTAGCGGCC
TGCGGGCCCTGGGCAGGCAAAAAACACTCA|GTCTTGCCTCCTCCTTGTCTCATGACAATC
CGGGTCGCTTGCTAGATTACTCTCTCCTCA|CGGCACGGATCTCAGTCACCGGGTTAAAAG
TGCGGGCCCTGGGCAGGCAAAAAACACTCA|ATTGCGGGCCCTGGGCAGGCAAAAAACACT
CTTGCCTCCTCCTTGTCTCATGACAATCAT|ATTGTATTGACTTTTAGGGTTCTAATGCAG
CTTGCTAGATTACTCTCTCCTCACACGGTG|GATCTCAGTCACCGGGTTAAAAGAAATTAG
CTGGGCAGGCAAAAAACACTCACTCCGGCG|TCCTCCTTGTCTCATGACAATCATTGACTA
ACTCAAAGTTAGCCCCTTTGTAGCGGCCTG|ACACTCGCGCCCTATTCAGCGGACGAGTTC
ACGAACCGGAATCCCTTGCTCGTTGCGGGC|ACCACCTAACTCCGCTATACCATATTGCGG
GAATCCCTTGCTCGTTGCGGGCCCTGGGCA|ACTCCGCTATACCATATTGCGGGCCCTGGG
TGGGCAGGCAAAAAACTTGCGGGCCCTGGG|ACACCTTGCAGAACGGGGTCTTGCCTCCTC
TGCAGTCCAGGCACCACCTAACTCCGCTAT|CGACTCATGCATCAAATGTGAGATGACTCT
CTGGGACAATCCTGACTGTTGCGGGCCCTG|CAGGCAAAAAACACTCACCCTTGCGGGCCC
GTTTCCGGACCTCCAGGCACGTGAAGACAG|ACTCTCTTATAGGTTGACTACGGGTCGCTT
CTCCGCTATACCATATTGCGGGCCCTGGGC|GATGACTCTAACGCAAACTTCGTCTACACC
AACACTCGAAGCTGCATGGCGCTAAGCCGT|AGAGTCTATCTTTACTCGAACAACGGTAAT
CGTAATCGACCTTGCGGGCCCTGGGCAGGC|CGCTGGGATTAAAATTTGCGGGCCCTGGGC
ACCACTACAGGGGTTGCGGGCCCTGGGCAG|GCGACACTGCCCACCATGGATGAATTAGCG
CACTCACCCTTGCGGGCCCTGGGCAGGCAA|AAAACACTCCATACTTACAACACCTTGCAG
TTGTCTCATGACAATCATTGACTACACGAA|TTTAGGGTTCTAATGCAGTCCAGGCACCAC
AGGGGTTGCGGGCCCTGGGCAGGCAAAAAA|GCCCACCATGGATGAATTAGCGCCACATCC
AATGTGGTACTTGCGGGCCCTGGGCAGGCA|AGCCTGGGACAATCCTGACTGTTGCGGGCC
GGGCAGGCAAAAAACACTCGGCCCTGGGCA|TGGTTGCGGGCCCTGGGCAGGCAAAAAACA
TGGGACAATCCTGACTGTTGCGGGCCCTGG|AGGCAAAAAACACTCACCCTTGCGGGCCCT
GCACGTGAAGACAGTGGTTGCGGGCCCTGG|ACTACGGGTCGCTTGCTAGATTACTCTCTC
CGGGCCCTGGGCAGGCAAAAAACACTCACT|CTTGCCTCCTCCTTGTCTCATGACAATCAT
CACTCGGCCCTGGGCAGGCAAAAAACACTC|GGGCAGGCAAAAAACACTCCCATAGAGTCT
CTACACCACTACAGGGGTTGCGGGCCCTGG|CTTAGCGACACTGCCCACCATGGATGAATT
CCATCTGCTGCGTAAACCAGCTGTTGACGT|CAAAAAACACTCGAAGCTGCATGGCGCTAA
AGATTACTCTCTCCTCACACGGTGCGGCAT|AGTCACCGGGTTAAAAGAAATTAGGCTGAC
CTCCCATAGAGTCTATCTTTACTCGAACAA|CATACCTACGAAAGTCTGCAATCGAGTGAG
TCTCAGCATAAGGCGAGTCCCGACGGTGAG|TGTGGTACTTGCGGGCCCTGGGCAGGCAAA
CCGCTATACCATATTGCGGGCCCTGGGCAG|TGACTCTAACGCAAACTTCGTCTACACCAC
GTGAGAGCCTGGGACAATCCTGACTGTTGC|GCCCTGGGCAGGCAAAAAACACTCACCCTT
ATCTTTACTCGAACAACGGTAATGTGGTAC|TCTGCAATCGAGTGAGTGAGAGCCTGGGAC
ACTCACCCTTGCGGGCCCTGGGCAGGCAAA|AAACACTCCATACTTACAACACCTTGCAGA
GCGGGCCCTGGGCAGGCAAAAAACACTCTG|CCAACCTGACCTTCTTTCCATGGTACGCTT
GGGCAGGCAAAAAACACTCGAAGCTGCATG|AAACACTCCCATAGAGTCTATCTTTACTCG
GGGTTAAAAGAAATTAGGCTGACGGAAGAC|CTCACTCCGGCGAATCCACTTAGCAATTCC
ACCTTGCAGAACGGGGTCTTGCCTCCTCCT|TGCACACACGTCAAACTATTGTATTGACTT
TACTTACAACACCTTGCAGAACGGGGTCTT|TGTAGCGGCCTGCACACACGTCAAACTATT
TACCGGAGCTCCTTGCGGGCCCTGGGCAGG|GCTCTCCTGTCGGGCATTTAAACTGTATAC
GTCTTGCCTCCTCCTTGTCTCATGACAATC|CTATTGTATTGACTTTTAGGGTTCTAATGC
CCCTGGGCAGGCAAAAAACACTCACCCTTG|CGGGCCCTGGGCAGGCAAAAAACACTCCAT
ACTCGAAGCTGCATGGCGCTAAGCCGTCTC|GTCTATCTTTACTCGAACAACGGTAATGTG
TGACCTTCTTTCCATGGTACGCTTAAAAGG|GGCGAGTCCCGACGGTGAGCACCGTTTCCG
TGCAGAACGGGGTCTTGCCTCCTCCTTGTC|CACACGTCAAACTATTGTATTGACTTTTAG
TCTACACCACTACAGGGGTTGCGGGCCCTG|ACTTAGCGACACTGCCCACCATGGATGAAT
TCCCTTGCTCGTTGCGGGCCCTGGGCAGGC|CCGCTATACCATATTGCGGGCCCTGGGCAG
TGGGCAGGCAAAAAACACTCTGCGGGCCCT|ACCTTCTTTCCATGGTACGCTTAAAAGGGC
AAAAAACACTCTGCGGGCCCTGGGCAGGCA|CCATGGTACGCTTAAAAGGGCACGTATTGC
TAGATTACTCTCTCCTCACACGGTGCGGCA|CAGTCACCGGGTTAAAAGAAATTAGGCTGA
TGGGCAGGCAAAAAACACTCACCCTTGCGG|GCCCTGGGCAGGCAAAAAACACTCCATACT
AGGCAAAAAACACTCACTCCGGCGAATCCA|TTGTCTCATGACAATCATTGACTACACGAA
ACCTACGAAAGTCTGCAATCGAGTGAGTGA|GGAAGACCACGTAATCGACCTTGCGGGCCC
CACCACTACAGGGGTTGCGGGCCCTGGGCA|AGCGACACTGCCCACCATGGATGAATTAGC
GGGCAGGCAAAAAACACTCTGCGGGCCCTG|CCTTCTTTCCATGGTACGCTTAAAAGGGCA
CTGGGCAGGCAAAAAACACTCATACTGAAC|ACTGTATACCGCGTACAGTGTCTGACACCG
CTATTCAGCGGACGAGTTCCCTGGCCCAAC|TGGGCAGGCAAAAAACACTCACGAACGCAG
ATCGAGTGAGTGAGAGCCTGGGACAATCCT|ACCTTGCGGGCCCTGGGCAGGCAAAAAACA
CATGCATCAAATGTGAGATGACTCTAACGC|CTTGCGGGCCCTGGGCAGGCAAAAAACACT
AGGCAAAAAACACTCCATACTTACAACACC|CTCAAAGTTAGCCCCTTTGTAGCGGCCTGC
AGTGAGTGAGAGCCTGGGACAATCCTGACT|TGCGGGCCCTGGGCAGGCAAAAAACACTCA
CACTCCCATAGAGTCTATCTTTACTCGAAC|GGCATACCTACGAAAGTCTGCAATCGAGTG
TCCCTGGCCCAACCTAAAGCCACGTACATT|CTCACGAACGCAGGTTCCGTTAATAGGAAT
ACACTCCATACTTACAACACCTTGCAGAAC|AGCCCCTTTGTAGCGGCCTGCACACACGTC
AATGTGAGATGACTCTAACGCAAACTTCGT|CCTGGGCAGGCAAAAAACACTCATACTGAA
CACGTCAAACTATTGTATTGACTTTTAGGG|GCCCAACCTAAAGCCACGTACATTGCATTA
GGCGCTAAGCCGTCTCAGCATAAGGCGAGT|GAACAACGGTAATGTGGTACTTGCGGGCCC
TTCCGGACCTCCAGGCACGTGAAGACAGTG|TCTCTTATAGGTTGACTACGGGTCGCTTGC
CCTTGCTCGTTGCGGGCCCTGGGCAGGCAA|GCTATACCATATTGCGGGCCCTGGGCAGGC
GCACCACCTAACTCCGCTATACCATATTGC|ATCAAATGTGAGATGACTCTAACGCAAACT
CACTCTGCGGGCCCTGGGCAGGCAAAAAAC|TACGCTTAAAAGGGCACGTATTGCGTTGCG
GAAGACCACGTAATCGACCTTGCGGGCCCT|AATTCCCTCGCTGGGATTAAAATTTGCGGG
AAAAACACTCTCTTATAGGTTGACTACGGG|CTGGGCAGGCAAAAAACACTCCTTTACGGC
CGTCTCAGCATAAGGCGAGTCCCGACGGTG|AATGTGGTACTTGCGGGCCCTGGGCAGGCA
CTGGGCAGGCAAAAAACACTCGGCCCTGGG|AGTGGTTGCGGGCCCTGGGCAGGCAAAAAA
CTGCGGGCCCTGGGCAGGCAAAAAACACTC|CTTAAAAGGGCACGTATTGCGTTGCGGGCC
TTGCGTTGCGGGCCCTGGGCAGGCAAAAAA|AGGCACGTGAAGACAGTGGTTGCGGGCCCT
TCGACCTTGCGGGCCCTGGGCAGGCAAAAA|GGATTAAAATTTGCGGGCCCTGGGCAGGCA
AACCTAAAGCCACGTACATTGCATTAGTAA|CAGGTTCCGTTAATAGGAATATGGGCTACC
CAGTCACCGGGTTAAAAGAAATTAGGCTGA|AAAAAACACTCACTCCGGCGAATCCACTTA