CATCCGGCTCTGGGCAAGAA -> ATCCGGCTCTGGGCAAGAAT
GACCCTGATTCCCTGGTTGC -> ACCCTGATTCCCTGGTTGCT
CCGCTAGTAGCACAGACAAC -> CGCTAGTAGCACAGACAACA
ATTCCTTGGCAGTTGTTGCG -> TTCCTTGGCAGTTGTTGCGC
ATTAGAGCCAATGGGTGACG -> TTAGAGCCAATGGGTGACGT
CCCTCTCTAGAGTGAGATAC -> CCTCTCTAGAGTGAGATACC
GAAAGGTTTTAAAGTTAGCG -> AAAGGTTTTAAAGTTAGCGG
AGGAAATCCCCTGCACGGTG -> GGAAATCCCCTGCACGGTGT
CTTAGATTCGTTGCTCCTCT -> TTAGATTCGTTGCTCCTCTC
AGGAGTTCCAGACGGTGCGA -> GGAGTTCCAGACGGTGCGAG
GGTGACGTTGGCGAACACCG -> GTGACGTTGGCGAACACCGC
GTGCTCCCAATGGGCGATAA -> TGCTCCCAATGGGCGATAAG
TACCGAGGTTAATCTGGACC -> ACCGAGGTTAATCTGGACCC
TATAATTTACCGAGGTTAAT -> ATAATTTACCGAGGTTAATC
GTGTTGTGTGGCTGGGCGTG -> TGTTGTGTGGCTGGGCGTGC
TCCCCTAGTCTATTCGTGTG -> CCCCTAGTCTATTCGTGTGC
GAGCCAATGGGTGACGTTGG -> AGCCAATGGGTGACGTTGGC
CTACAATGGCCCTATAAGGT -> TACAATGGCCCTATAAGGTT
CAACTTGCGCGTAGGGGTTT -> AACTTGCGCGTAGGGGTTTG
AGATTCGTTGCTCCTCTCGA -> GATTCGTTGCTCCTCTCGAG
TAAGAAACGCGAGTGCCTAT -> AAGAAACGCGAGTGCCTATA
AGAGCCAATGGGTGACGTTG -> GAGCCAATGGGTGACGTTGG
GAACTCTCACTTGGTTCCAC -> AACTCTCACTTGGTTCCACT
CGCATAGGTATAATTTACCG -> GCATAGGTATAATTTACCGA
CGGAACTAGAGTCGATAGGT -> GGAACTAGAGTCGATAGGTA
AAAAAAAGGGCACGAAAGGT -> AAAAAAGGGCACGAAAGGTT
CTTATTTCGAATCACGACCT -> TTATTTCGAATCACGACCTT
AAGTTAGCGGAGCTCCTTCA -> AGTTAGCGGAGCTCCTTCAC
TGCGCGTAGGGGTTTGTGTA -> GCGCGTAGGGGTTTGTGTAT
CTCCTTCACCCGCTAGTAGC -> TCCTTCACCCGCTAGTAGCA
TAATGATAGCAACTTGCGCG -> AATGATAGCAACTTGCGCGT
TACCAGATTCCTTGGCAGTT -> ACCAGATTCCTTGGCAGTTG
TCGTGTGCGGCCCGGCACGT -> CGTGTGCGGCCCGGCACGTG
TGCTTATTTCGAATCACGAC -> GCTTATTTCGAATCACGACC
GACTCCGTGCCTGTATCCAG -> ACTCCGTGCCTGTATCCAGA
AAAGTTAGCGGAGCTCCTTC -> AAGTTAGCGGAGCTCCTTCA
ACTTATACATCGTGCTCCCA -> CTTATACATCGTGCTCCCAA
CCCGTGGATTGCCTGATCAA -> CCGTGGATTGCCTGATCAAT
TTTTGGCCAGTTCAAATCTT -> TTTGGCCAGTTCAAATCTTA
AGGTTAATCTGGACCCTGAT -> GGTTAATCTGGACCCTGATT
CACTATGCCAATAAGAAACG -> ACTATGCCAATAAGAAACGC
GGGCGTGCTTCAGCTACAGA -> GGCGTGCTTCAGCTACAGAG
TCTGGACCCTGATTCCCTGG -> CTGGACCCTGATTCCCTGGT
CAGCTAGTACCAGGAAATCC -> AGCTAGTACCAGGAAATCCC
CTTGAGTGGAGGTGGCGATG -> TTGAGTGGAGGTGGCGATGC
CGGTTCTTGCGCGAAAGAAC -> GGTTCTTGCGCGAAAGAACC
AGTCGGTTCTTGCGCGAAAG -> GTCGGTTCTTGCGCGAAAGA
GGAAATCCCCTGCACGGTGT -> GAAATCCCCTGCACGGTGTT
AACCGTTTTGATGAATCCCG -> ACCGTTTTGATGAATCCCGT
AGACAACAGTCGGTTCTTGC -> GACAACAGTCGGTTCTTGCG
TAGAGCCAATGGGTGACGTT -> AGAGCCAATGGGTGACGTTG
CCTCCAGGTTGACCGTATCA -> CTCCAGGTTGACCGTATCAT
CTTGTTTGTCAAGGGACCAA -> TTGTTTGTCAAGGGACCAAA
CCTTGAGTGGAGGTGGCGAT -> CTTGAGTGGAGGTGGCGATG
ATCGTGCTCCCAATGGGCGA -> TCGTGCTCCCAATGGGCGAT
TTTTAAAGTTAGCGGAGCTC -> TTTAAAGTTAGCGGAGCTCC
ACTTTTGAGTGACCTTGAGT -> CTTTTGAGTGACCTTGAGTG
CAAGGGACCAAAAAAAGGGC -> AAGGGACCAAAAAAAGGGCA
TCGATAGGTACTAATGATAG -> CGATAGGTACTAATGATAGC
ACTGCGGAACTAGAGTCGAT -> CTGCGGAACTAGAGTCGATA
GGATTGCCTGATCAATGTGT -> GATTGCCTGATCAATGTGTT
GCTAGTAGCACAGACAACAG -> CTAGTAGCACAGACAACAGT
GATAGCAACTTGCGCGTAGG -> ATAGCAACTTGCGCGTAGGG
TACTAATGATAGCAACTTGC -> ACTAATGATAGCAACTTGCG
CTGATCAATGTGTTGGTGGC -> TGATCAATGTGTTGGTGGCA
TCGTAGGAGTTCCAGACGGT -> CGTAGGAGTTCCAGACGGTG
GAACCGTTTTGATGAATCCC -> AACCGTTTTGATGAATCCCG
TCCCTGGTTGCTATGCGACT -> CCCTGGTTGCTATGCGACTA
TGTTGTGTGGCTGGGCGTGC -> GTTGTGTGGCTGGGCGTGCT
ACCAGATTCCTTGGCAGTTG -> CCAGATTCCTTGGCAGTTGT
TCTTGTTTGTCAAGGGACCA -> CTTGTTTGTCAAGGGACCAA
TGCAGGTCCAAGACAGTCTA -> GCAGGTCCAAGACAGTCTAC
TTGCCCGTGGCTTCCAGTCG -> TGCCCGTGGCTTCCAGTCGG
CGGGCCATCACCTCGCATAG -> GGGCCATCACCTCGCATAGG
TACAATGGCCCTATAAGGTT -> ACAATGGCCCTATAAGGTTT
CACCTCGCATAGGTATAATT -> ACCTCGCATAGGTATAATTT
TGGTTGCTATGCGACTAGAA -> GGTTGCTATGCGACTAGAAC
CCTTCGTAGGAGTTCCAGAC -> CTTCGTAGGAGTTCCAGACG
GCAGCTAGTACCAGGAAATC -> CAGCTAGTACCAGGAAATCC
AAGGGACCAAAAAAAGGGCA -> AGGGACCAAAAAAAGGGCAC
AATCTTAATAGTCACTCCAT -> ATCTTAATAGTCACTCCATC
TGGATTGCCTGATCAATGTG -> GGATTGCCTGATCAATGTGT
TAGTCTATTCGTGTGCGGCC -> AGTCTATTCGTGTGCGGCCC
AACTAGAGTCGATAGGTACT -> ACTAGAGTCGATAGGTACTA
TATGCCAATAAGAAACGCGA -> ATGCCAATAAGAAACGCGAG
CATCAATTTGCCCGTGGCTT -> ATCAATTTGCCCGTGGCTTC
GCTCCTGGTTACTTATACAT -> CTCCTGGTTACTTATACATC
ATGAATCCCGTGGATTGCCT -> TGAATCCCGTGGATTGCCTG
GGCCATCACCTCGCATAGGT -> GCCATCACCTCGCATAGGTA
GTAGGAGTTCCAGACGGTGC -> TAGGAGTTCCAGACGGTGCG
ATAATTTACCGAGGTTAATC -> TAATTTACCGAGGTTAATCT
GAACACCGCGACTGCCCTCT -> AACACCGCGACTGCCCTCTC
TCACTTGGTTCCACTATGCC -> CACTTGGTTCCACTATGCCA
AATAGTCACTCCATCCGGCT -> ATAGTCACTCCATCCGGCTC
TATCATACATGCGCGCGACG -> ATCATACATGCGCGCGACGT
GTACTAATGATAGCAACTTG -> TACTAATGATAGCAACTTGC
CTAGAGTGAGATACCAGATT -> TAGAGTGAGATACCAGATTC
AGAGTGAGATACCAGATTCC -> GAGTGAGATACCAGATTCCT
TCCCCACATCGACTCCGTGC -> CCCCACATCGACTCCGTGCC
GCGCGCGACGTGTATGGTAT -> CGCGCGACGTGTATGGTATG
AGCATGGCATCTCCCCTAGT -> GCATGGCATCTCCCCTAGTC
AGTCACTCCATCCGGCTCTG -> GTCACTCCATCCGGCTCTGG
GTAGGGGTTTGTGTATCAGA -> TAGGGGTTTGTGTATCAGAA
TCGAGCGGACTGCAGGAACT -> CGAGCGGACTGCAGGAACTC
GTCGGAGGACTTTTGAGTGA -> TCGGAGGACTTTTGAGTGAC
GTTTTGATGAATCCCGTGGA -> TTTTGATGAATCCCGTGGAT
GTTTTAAAGTTAGCGGAGCT -> TTTTAAAGTTAGCGGAGCTC
TTGGCCAGTTCAAATCTTAA -> TGGCCAGTTCAAATCTTAAT
TTGCCTGATCAATGTGTTGG -> TGCCTGATCAATGTGTTGGT
GGTTCTTGCGCGAAAGAACC -> GTTCTTGCGCGAAAGAACCG
AGTTGCAGCTAGTACCAGGA -> GTTGCAGCTAGTACCAGGAA
CAGCTACAGAGAGTGCTACA -> AGCTACAGAGAGTGCTACAA
GGCACGAAAGGTTTTAAAGT -> GCACGAAAGGTTTTAAAGTT
GCATGGCATCTCCCCTAGTC -> CATGGCATCTCCCCTAGTCT
GCTTCAGCTACAGAGAGTGC -> CTTCAGCTACAGAGAGTGCT
TCCCTGATATGTGCAGGTCC -> CCCTGATATGTGCAGGTCCA
CTTGCGCGAAAGAACCGTTT -> TTGCGCGAAAGAACCGTTTT
CAGATTCCTTGGCAGTTGTT -> AGATTCCTTGGCAGTTGTTG
CCTTCACCCGCTAGTAGCAC -> CTTCACCCGCTAGTAGCACA
AAGGTTTATGTTCCCCACAT -> AGGTTTATGTTCCCCACATC
GCTGGGCGTGCTTCAGCTAC -> CTGGGCGTGCTTCAGCTACA
CCTGTATCCAGAGTAACTTT -> CTGTATCCAGAGTAACTTTT
GGCCCTATAAGGTTTATGTT -> GCCCTATAAGGTTTATGTTC
GGGCAAGAATCCCTGATATG -> GGCAAGAATCCCTGATATGT
CCAAGACAGTCTACGGGCCA -> CAAGACAGTCTACGGGCCAT
CCGGCACGTGCTTATTTCGA -> CGGCACGTGCTTATTTCGAA
ACCAGGAAATCCCCTGCACG -> CCAGGAAATCCCCTGCACGG
CCAGGAAATCCCCTGCACGG -> CAGGAAATCCCCTGCACGGT
GTCGATAGGTACTAATGATA -> TCGATAGGTACTAATGATAG
CGAGGTTAATCTGGACCCTG -> GAGGTTAATCTGGACCCTGA
ATTCGTTGCTCCTCTCGAGC -> TTCGTTGCTCCTCTCGAGCG
ATACATGCGCGCGACGTGTA -> TACATGCGCGCGACGTGTAT
TAGTCACTCCATCCGGCTCT -> AGTCACTCCATCCGGCTCTG
ATAGGTATAATTTACCGAGG -> TAGGTATAATTTACCGAGGT
GGGCTTAGATTCGTTGCTCC -> GGCTTAGATTCGTTGCTCCT
TTGGTGGCACTATTTTGGCC -> TGGTGGCACTATTTTGGCCA
TCCAGACGGTGCGAGGCGGA -> CCAGACGGTGCGAGGCGGAC
TCACCCGCTAGTAGCACAGA -> CACCCGCTAGTAGCACAGAC
TGCGCTCCTGGTTACTTATA -> GCGCTCCTGGTTACTTATAC
GCATCAATTTGCCCGTGGCT -> CATCAATTTGCCCGTGGCTT
CCCGTGGCTTCCAGTCGGAG -> CCGTGGCTTCCAGTCGGAGG
ACGTGTATGGTATGGAATTA -> CGTGTATGGTATGGAATTAG
GAGTCGATAGGTACTAATGA -> AGTCGATAGGTACTAATGAT
GGTTGACCGTATCATACATG -> GTTGACCGTATCATACATGC
CCTGATTCCCTGGTTGCTAT -> CTGATTCCCTGGTTGCTATG
TGCACGGTGTTGTGTGGCTG -> GCACGGTGTTGTGTGGCTGG
AATCTGGACCCTGATTCCCT -> ATCTGGACCCTGATTCCCTG
AGACAGTCTACGGGCCATCA -> GACAGTCTACGGGCCATCAC
GTGGCTTCCAGTCGGAGGAC -> TGGCTTCCAGTCGGAGGACT
CTTGGCAGTTGTTGCGCTCC -> TTGGCAGTTGTTGCGCTCCT
AAATCCCCTGCACGGTGTTG -> AATCCCCTGCACGGTGTTGT
GGAGGTGGCGATGCGCACTG -> GAGGTGGCGATGCGCACTGC
TGGGCAAGAATCCCTGATAT -> GGGCAAGAATCCCTGATATG
TTAATCTGGACCCTGATTCC -> TAATCTGGACCCTGATTCCC
TTGTGTATCAGAACTCGAGG -> TGTGTATCAGAACTCGAGGG
CAGTCTACGGGCCATCACCT -> AGTCTACGGGCCATCACCTC
GCAACTTGCGCGTAGGGGTT -> CAACTTGCGCGTAGGGGTTT
TTGGCAGTTGTTGCGCTCCT -> TGGCAGTTGTTGCGCTCCTG
CCTAGTCTATTCGTGTGCGG -> CTAGTCTATTCGTGTGCGGC
TTTGAGTGACCTTGAGTGGA -> TTGAGTGACCTTGAGTGGAG
AGAACATTGGCTTATTCCGA -> GAACATTGGCTTATTCCGAC
TGCTACAATGGCCCTATAAG -> GCTACAATGGCCCTATAAGG
TATTTCGAATCACGACCTTC -> ATTTCGAATCACGACCTTCG
GCTCCTTCACCCGCTAGTAG -> CTCCTTCACCCGCTAGTAGC
GGTTACTTATACATCGTGCT -> GTTACTTATACATCGTGCTC
CCTGATATGTGCAGGTCCAA -> CTGATATGTGCAGGTCCAAG
CTGCACGGTGTTGTGTGGCT -> TGCACGGTGTTGTGTGGCTG
GGCAGTTGTTGCGCTCCTGG -> GCAGTTGTTGCGCTCCTGGT
GCAGGTCCAAGACAGTCTAC -> CAGGTCCAAGACAGTCTACG
GCTCCTCTCGAGCGGACTGC -> CTCCTCTCGAGCGGACTGCA
TGGCTGGGCGTGCTTCAGCT -> GGCTGGGCGTGCTTCAGCTA
ACCGTATCATACATGCGCGC -> CCGTATCATACATGCGCGCG
GAATCCCTGATATGTGCAGG -> AATCCCTGATATGTGCAGGT
CTCTGGGCAAGAATCCCTGA -> TCTGGGCAAGAATCCCTGAT
CTCCCAATGGGCGATAAGCA -> TCCCAATGGGCGATAAGCAT
GCATAGGTATAATTTACCGA -> CATAGGTATAATTTACCGAG
GGGCGATAAGCATCAATTTG -> GGCGATAAGCATCAATTTGC
GGTGGCGATGCGCACTGCGG -> GTGGCGATGCGCACTGCGGA
AGTCTATTCGTGTGCGGCCC -> GTCTATTCGTGTGCGGCCCG
CATGCTCTCTTGTTTGTCAA -> ATGCTCTCTTGTTTGTCAAG
CCGACCTCCAGGTTGACCGT -> CGACCTCCAGGTTGACCGTA
ATTGGCTTATTCCGACCTCC -> TTGGCTTATTCCGACCTCCA
ACTTGCGCGTAGGGGTTTGT -> CTTGCGCGTAGGGGTTTGTG
AACAGTCGGTTCTTGCGCGA -> ACAGTCGGTTCTTGCGCGAA
ATTCCCTGGTTGCTATGCGA -> TTCCCTGGTTGCTATGCGAC
TGATTCCCTGGTTGCTATGC -> GATTCCCTGGTTGCTATGCG
ACTAATGATAGCAACTTGCG -> CTAATGATAGCAACTTGCGC
CGTGCTTATTTCGAATCACG -> GTGCTTATTTCGAATCACGA
TCTGGGCAAGAATCCCTGAT -> CTGGGCAAGAATCCCTGATA
CCGGCTCTGGGCAAGAATCC -> CGGCTCTGGGCAAGAATCCC
GGAATTAGAGCCAATGGGTG -> GAATTAGAGCCAATGGGTGA
ACATCGACTCCGTGCCTGTA -> CATCGACTCCGTGCCTGTAT
TGGCTTATTCCGACCTCCAG -> GGCTTATTCCGACCTCCAGG
AGGTCCAAGACAGTCTACGG -> GGTCCAAGACAGTCTACGGG
TAGGGGTTTGTGTATCAGAA -> AGGGGTTTGTGTATCAGAAC
CTGATATGTGCAGGTCCAAG -> TGATATGTGCAGGTCCAAGA
TCCCAATGGGCGATAAGCAT -> CCCAATGGGCGATAAGCATC
CCTGATCAATGTGTTGGTGG -> CTGATCAATGTGTTGGTGGC
GACAACAGTCGGTTCTTGCG -> ACAACAGTCGGTTCTTGCGC
TCCTTGGCAGTTGTTGCGCT -> CCTTGGCAGTTGTTGCGCTC
TAGGAGTTCCAGACGGTGCG -> AGGAGTTCCAGACGGTGCGA
TAGGTACTAATGATAGCAAC -> AGGTACTAATGATAGCAACT
CAATGTGTTGGTGGCACTAT -> AATGTGTTGGTGGCACTATT
GTGACGTTGGCGAACACCGC -> TGACGTTGGCGAACACCGCG
CGTGCTTCAGCTACAGAGAG -> GTGCTTCAGCTACAGAGAGT
ACTTGGTTCCACTATGCCAA -> CTTGGTTCCACTATGCCAAT
TGCCTGTATCCAGAGTAACT -> GCCTGTATCCAGAGTAACTT
ATGCCAATAAGAAACGCGAG -> TGCCAATAAGAAACGCGAGT
TAACTTTTCGCTCGGTACAT -> AACTTTTCGCTCGGTACATG
GGTTAATCTGGACCCTGATT -> GTTAATCTGGACCCTGATTC
AATCACGACCTTCGTAGGAG -> ATCACGACCTTCGTAGGAGT
CCCTATAAGGTTTATGTTCC -> CCTATAAGGTTTATGTTCCC
GCCAATGGGTGACGTTGGCG -> CCAATGGGTGACGTTGGCGA
CACGTGCTTATTTCGAATCA -> ACGTGCTTATTTCGAATCAC
TAAGGTTTATGTTCCCCACA -> AAGGTTTATGTTCCCCACAT
TATACATCGTGCTCCCAATG -> ATACATCGTGCTCCCAATGG
TGCAGCTAGTACCAGGAAAT -> GCAGCTAGTACCAGGAAATC
GTTACTTATACATCGTGCTC -> TTACTTATACATCGTGCTCC
ATCGACTCCGTGCCTGTATC -> TCGACTCCGTGCCTGTATCC
TTGACCGTATCATACATGCG -> TGACCGTATCATACATGCGC
ATAAGCATCAATTTGCCCGT -> TAAGCATCAATTTGCCCGTG
GAAACGCGAGTGCCTATATT -> AAACGCGAGTGCCTATATTA
GATATGTGCAGGTCCAAGAC -> ATATGTGCAGGTCCAAGACA
ACATTGGCTTATTCCGACCT -> CATTGGCTTATTCCGACCTC
TGATATGTGCAGGTCCAAGA -> GATATGTGCAGGTCCAAGAC
ATACCAGATTCCTTGGCAGT -> TACCAGATTCCTTGGCAGTT
GGGGGCTTAGATTCGTTGCT -> GGGGCTTAGATTCGTTGCTC
TTTACCGAGGTTAATCTGGA -> TTACCGAGGTTAATCTGGAC
ACCTTGAGTGGAGGTGGCGA -> CCTTGAGTGGAGGTGGCGAT
TGGGCGATAAGCATCAATTT -> GGGCGATAAGCATCAATTTG
ACCGCGACTGCCCTCTCTAG -> CCGCGACTGCCCTCTCTAGA
ATAAGGTTTATGTTCCCCAC -> TAAGGTTTATGTTCCCCACA
TCCCGTGGATTGCCTGATCA -> CCCGTGGATTGCCTGATCAA
GTTGCTCCTCTCGAGCGGAC -> TTGCTCCTCTCGAGCGGACT
CTAATGATAGCAACTTGCGC -> TAATGATAGCAACTTGCGCG
TCTCCCCTAGTCTATTCGTG -> CTCCCCTAGTCTATTCGTGT
CATAGGTATAATTTACCGAG -> ATAGGTATAATTTACCGAGG
AGCAACTTGCGCGTAGGGGT -> GCAACTTGCGCGTAGGGGTT
GAATCCCGTGGATTGCCTGA -> AATCCCGTGGATTGCCTGAT
TAATTTACCGAGGTTAATCT -> AATTTACCGAGGTTAATCTG
GCTCTCTTGTTTGTCAAGGG -> CTCTCTTGTTTGTCAAGGGA
CAATTTGCCCGTGGCTTCCA -> AATTTGCCCGTGGCTTCCAG
GGGTTTGTGTATCAGAACTC -> GGTTTGTGTATCAGAACTCG
AACACCGCGACTGCCCTCTC -> ACACCGCGACTGCCCTCTCT
TTATTTCGAATCACGACCTT -> TATTTCGAATCACGACCTTC
GGCGAACACCGCGACTGCCC -> GCGAACACCGCGACTGCCCT
ACTAGAGTCGATAGGTACTA -> CTAGAGTCGATAGGTACTAA
CACGAAAGGTTTTAAAGTTA -> ACGAAAGGTTTTAAAGTTAG
TACAGAGAGTGCTACAATGG -> ACAGAGAGTGCTACAATGGC
TAGCACAGACAACAGTCGGT -> AGCACAGACAACAGTCGGTT
GTGCCTATATTACGGAGGGC -> TGCCTATATTACGGAGGGCG
GTGAGATACCAGATTCCTTG -> TGAGATACCAGATTCCTTGG
GGTTTGTGTATCAGAACTCG -> GTTTGTGTATCAGAACTCGA
CGACTCCGTGCCTGTATCCA -> GACTCCGTGCCTGTATCCAG
TTGCGCGTAGGGGTTTGTGT -> TGCGCGTAGGGGTTTGTGTA
CTGTATCCAGAGTAACTTTT -> TGTATCCAGAGTAACTTTTC
CAGACGGTGCGAGGCGGACC -> AGACGGTGCGAGGCGGACCC
TGTGTTGGTGGCACTATTTT -> GTGTTGGTGGCACTATTTTG
TTTATGTTCCCCACATCGAC -> TTATGTTCCCCACATCGACT
GTAGTTGCAGCTAGTACCAG -> TAGTTGCAGCTAGTACCAGG
TGTATCCAGAGTAACTTTTC -> GTATCCAGAGTAACTTTTCG
CGTGGCTTCCAGTCGGAGGA -> GTGGCTTCCAGTCGGAGGAC
TGCTATGCGACTAGAACATT -> GCTATGCGACTAGAACATTG
ATAGTCACTCCATCCGGCTC -> TAGTCACTCCATCCGGCTCT
TAGTAGCACAGACAACAGTC -> AGTAGCACAGACAACAGTCG
CTTCACCCGCTAGTAGCACA -> TTCACCCGCTAGTAGCACAG
TTTCGAATCACGACCTTCGT -> TTCGAATCACGACCTTCGTA
GGAGTTCCAGACGGTGCGAG -> GAGTTCCAGACGGTGCGAGG
GCGAAAGAACCGTTTTGATG -> CGAAAGAACCGTTTTGATGA
TGCTCTCTTGTTTGTCAAGG -> GCTCTCTTGTTTGTCAAGGG
TTGCTATGCGACTAGAACAT -> TGCTATGCGACTAGAACATT
GGCACTATTTTGGCCAGTTC -> GCACTATTTTGGCCAGTTCA
CCTATAAGGTTTATGTTCCC -> CTATAAGGTTTATGTTCCCC
CTGATTCCCTGGTTGCTATG -> TGATTCCCTGGTTGCTATGC
GTATAATTTACCGAGGTTAA -> TATAATTTACCGAGGTTAAT
CAATGGGCGATAAGCATCAA -> AATGGGCGATAAGCATCAAT
GCTCGGTACATGCTCTCTTG -> CTCGGTACATGCTCTCTTGT
AACTTGCGCGTAGGGGTTTG -> ACTTGCGCGTAGGGGTTTGT
GCGATGCGCACTGCGGAACT -> CGATGCGCACTGCGGAACTA
TGCCCTCTCTAGAGTGAGAT -> GCCCTCTCTAGAGTGAGATA
AGAATCCCTGATATGTGCAG -> GAATCCCTGATATGTGCAGG
GTTGTGTGGCTGGGCGTGCT -> TTGTGTGGCTGGGCGTGCTT
AGCGGACTGCAGGAACTCTC -> GCGGACTGCAGGAACTCTCA
ATCAATGTGTTGGTGGCACT -> TCAATGTGTTGGTGGCACTA
GAAAGAACCGTTTTGATGAA -> AAAGAACCGTTTTGATGAAT
CAGTCGGTTCTTGCGCGAAA -> AGTCGGTTCTTGCGCGAAAG
TGCGAGGCGGACCCAATGTA -> GCGAGGCGGACCCAATGTAG
TTCCTTGGCAGTTGTTGCGC -> TCCTTGGCAGTTGTTGCGCT
ACTCGAGGGGGGCTTAGATT -> CTCGAGGGGGGCTTAGATTC
ATGCTCTCTTGTTTGTCAAG -> TGCTCTCTTGTTTGTCAAGG
GCAGTTGTTGCGCTCCTGGT -> CAGTTGTTGCGCTCCTGGTT
TCCAGGTTGACCGTATCATA -> CCAGGTTGACCGTATCATAC
TTTTGAGTGACCTTGAGTGG -> TTTGAGTGACCTTGAGTGGA
AAAAAAGGGCACGAAAGGTT -> AAAAAGGGCACGAAAGGTTT
CGTTGCTCCTCTCGAGCGGA -> GTTGCTCCTCTCGAGCGGAC
TATGGAATTAGAGCCAATGG -> ATGGAATTAGAGCCAATGGG
TGATCAATGTGTTGGTGGCA -> GATCAATGTGTTGGTGGCAC
ACCCTGATTCCCTGGTTGCT -> CCCTGATTCCCTGGTTGCTA
TGGCAGTTGTTGCGCTCCTG -> GGCAGTTGTTGCGCTCCTGG
TCGTGCTCCCAATGGGCGAT -> CGTGCTCCCAATGGGCGATA
ATCCCGTGGATTGCCTGATC -> TCCCGTGGATTGCCTGATCA
CGTTTTGATGAATCCCGTGG -> GTTTTGATGAATCCCGTGGA
CTTATTCCGACCTCCAGGTT -> TTATTCCGACCTCCAGGTTG
TGACCGTATCATACATGCGC -> GACCGTATCATACATGCGCG
GATTCGTTGCTCCTCTCGAG -> ATTCGTTGCTCCTCTCGAGC
AGCTCCTTCACCCGCTAGTA -> GCTCCTTCACCCGCTAGTAG
GAATCACGACCTTCGTAGGA -> AATCACGACCTTCGTAGGAG
CATGGCATCTCCCCTAGTCT -> ATGGCATCTCCCCTAGTCTA
GCCCGGCACGTGCTTATTTC -> CCCGGCACGTGCTTATTTCG
GAGCTCCTTCACCCGCTAGT -> AGCTCCTTCACCCGCTAGTA
TCACCTCGCATAGGTATAAT -> CACCTCGCATAGGTATAATT
ACGCGAGTGCCTATATTACG -> CGCGAGTGCCTATATTACGG
ATGGGCGATAAGCATCAATT -> TGGGCGATAAGCATCAATTT
GCACGTGCTTATTTCGAATC -> CACGTGCTTATTTCGAATCA
ATTTACCGAGGTTAATCTGG -> TTTACCGAGGTTAATCTGGA
AAGAATCCCTGATATGTGCA -> AGAATCCCTGATATGTGCAG
GATAAGCATCAATTTGCCCG -> ATAAGCATCAATTTGCCCGT
ACCGAGGTTAATCTGGACCC -> CCGAGGTTAATCTGGACCCT
ATACATCGTGCTCCCAATGG -> TACATCGTGCTCCCAATGGG
CAAGCATGGCATCTCCCCTA -> AAGCATGGCATCTCCCCTAG
GATTCCTTGGCAGTTGTTGC -> ATTCCTTGGCAGTTGTTGCG
ATGCGACTAGAACATTGGCT -> TGCGACTAGAACATTGGCTT
TGGAATTAGAGCCAATGGGT -> GGAATTAGAGCCAATGGGTG
CCCGCTAGTAGCACAGACAA -> CCGCTAGTAGCACAGACAAC
TTTGTGTATCAGAACTCGAG -> TTGTGTATCAGAACTCGAGG
TCAAATCTTAATAGTCACTC -> CAAATCTTAATAGTCACTCC
GAACATTGGCTTATTCCGAC -> AACATTGGCTTATTCCGACC
AATGATAGCAACTTGCGCGT -> ATGATAGCAACTTGCGCGTA
ATCAATTTGCCCGTGGCTTC -> TCAATTTGCCCGTGGCTTCC
GGTATGGAATTAGAGCCAAT -> GTATGGAATTAGAGCCAATG
TAATAGTCACTCCATCCGGC -> AATAGTCACTCCATCCGGCT
GCGCGAAAGAACCGTTTTGA -> CGCGAAAGAACCGTTTTGAT
CATCGACTCCGTGCCTGTAT -> ATCGACTCCGTGCCTGTATC
CACGACCTTCGTAGGAGTTC -> ACGACCTTCGTAGGAGTTCC
CCAGGTTGACCGTATCATAC -> CAGGTTGACCGTATCATACA
TCCATCCGGCTCTGGGCAAG -> CCATCCGGCTCTGGGCAAGA
TAATCTGGACCCTGATTCCC -> AATCTGGACCCTGATTCCCT
TGCGCGAAAGAACCGTTTTG -> GCGCGAAAGAACCGTTTTGA
GCAAGAATCCCTGATATGTG -> CAAGAATCCCTGATATGTGC
AAGAACCGTTTTGATGAATC -> AGAACCGTTTTGATGAATCC
CGGACCCAATGTAGTTGCAG -> GGACCCAATGTAGTTGCAGC
GCTCTGGGCAAGAATCCCTG -> CTCTGGGCAAGAATCCCTGA
TATGTGCAGGTCCAAGACAG -> ATGTGCAGGTCCAAGACAGT
CGAAAGAACCGTTTTGATGA -> GAAAGAACCGTTTTGATGAA
GTTGGTGGCACTATTTTGGC -> TTGGTGGCACTATTTTGGCC
CGGAGGACTTTTGAGTGACC -> GGAGGACTTTTGAGTGACCT
TCTCGAGCGGACTGCAGGAA -> CTCGAGCGGACTGCAGGAAC
GTTCTTGCGCGAAAGAACCG -> TTCTTGCGCGAAAGAACCGT
TCGGAGGACTTTTGAGTGAC -> CGGAGGACTTTTGAGTGACC
GCACTGCGGAACTAGAGTCG -> CACTGCGGAACTAGAGTCGA
TGCGCGCGACGTGTATGGTA -> GCGCGCGACGTGTATGGTAT
GCATCTCCCCTAGTCTATTC -> CATCTCCCCTAGTCTATTCG
CTGGTTACTTATACATCGTG -> TGGTTACTTATACATCGTGC
GAGTGACCTTGAGTGGAGGT -> AGTGACCTTGAGTGGAGGTG
GGCCCGGCACGTGCTTATTT -> GCCCGGCACGTGCTTATTTC
CGACTGCCCTCTCTAGAGTG -> GACTGCCCTCTCTAGAGTGA
TGCCAATAAGAAACGCGAGT -> GCCAATAAGAAACGCGAGTG
ACACCGCGACTGCCCTCTCT -> CACCGCGACTGCCCTCTCTA
CTCTCGAGCGGACTGCAGGA -> TCTCGAGCGGACTGCAGGAA
TTCGTGTGCGGCCCGGCACG -> TCGTGTGCGGCCCGGCACGT
CGAGGCGGACCCAATGTAGT -> GAGGCGGACCCAATGTAGTT
CGACCTTCGTAGGAGTTCCA -> GACCTTCGTAGGAGTTCCAG
GGGACCAAAAAAAGGGCACG -> GGACCAAAAAAAGGGCACGA
CCCCTGCACGGTGTTGTGTG -> CCCTGCACGGTGTTGTGTGG
TATCCAGAGTAACTTTTCGC -> ATCCAGAGTAACTTTTCGCT
CCAAGCATGGCATCTCCCCT -> CAAGCATGGCATCTCCCCTA
GCGTGCTTCAGCTACAGAGA -> CGTGCTTCAGCTACAGAGAG
GATTCCCTGGTTGCTATGCG -> ATTCCCTGGTTGCTATGCGA
TACCAGGAAATCCCCTGCAC -> ACCAGGAAATCCCCTGCACG
CTGGGCGTGCTTCAGCTACA -> TGGGCGTGCTTCAGCTACAG
CGGCCCGGCACGTGCTTATT -> GGCCCGGCACGTGCTTATTT
GGTGGCACTATTTTGGCCAG -> GTGGCACTATTTTGGCCAGT
CCACTATGCCAATAAGAAAC -> CACTATGCCAATAAGAAACG
GCGCTCCTGGTTACTTATAC -> CGCTCCTGGTTACTTATACA
GGCATCTCCCCTAGTCTATT -> GCATCTCCCCTAGTCTATTC
TGCTTCAGCTACAGAGAGTG -> GCTTCAGCTACAGAGAGTGC
AGATACCAGATTCCTTGGCA -> GATACCAGATTCCTTGGCAG
GCGAGGCGGACCCAATGTAG -> CGAGGCGGACCCAATGTAGT
TGCCCGTGGCTTCCAGTCGG -> GCCCGTGGCTTCCAGTCGGA
GTATGGTATGGAATTAGAGC -> TATGGTATGGAATTAGAGCC
ATGGAATTAGAGCCAATGGG -> TGGAATTAGAGCCAATGGGT
CGCGAGTGCCTATATTACGG -> GCGAGTGCCTATATTACGGA
ATCTCCCCTAGTCTATTCGT -> TCTCCCCTAGTCTATTCGTG
GACTTTTGAGTGACCTTGAG -> ACTTTTGAGTGACCTTGAGT
ATATGTGCAGGTCCAAGACA -> TATGTGCAGGTCCAAGACAG
CAGTTCAAATCTTAATAGTC -> AGTTCAAATCTTAATAGTCA
TTGCTCCTCTCGAGCGGACT -> TGCTCCTCTCGAGCGGACTG
TTCCAGACGGTGCGAGGCGG -> TCCAGACGGTGCGAGGCGGA
CATGCGCGCGACGTGTATGG -> ATGCGCGCGACGTGTATGGT
AGAGTAACTTTTCGCTCGGT -> GAGTAACTTTTCGCTCGGTA
TGTGCAGGTCCAAGACAGTC -> GTGCAGGTCCAAGACAGTCT
CTTCGTAGGAGTTCCAGACG -> TTCGTAGGAGTTCCAGACGG
GGTACATGCTCTCTTGTTTG -> GTACATGCTCTCTTGTTTGT
TCGAATCACGACCTTCGTAG -> CGAATCACGACCTTCGTAGG
ATCATACATGCGCGCGACGT -> TCATACATGCGCGCGACGTG
ACTCTCACTTGGTTCCACTA -> CTCTCACTTGGTTCCACTAT
TGTGGCTGGGCGTGCTTCAG -> GTGGCTGGGCGTGCTTCAGC
GACCTTGAGTGGAGGTGGCG -> ACCTTGAGTGGAGGTGGCGA
CCGTTTTGATGAATCCCGTG -> CGTTTTGATGAATCCCGTGG
GTCACTCCATCCGGCTCTGG -> TCACTCCATCCGGCTCTGGG
GAGTGAGATACCAGATTCCT -> AGTGAGATACCAGATTCCTT
GCTCCCAATGGGCGATAAGC -> CTCCCAATGGGCGATAAGCA
CGGAGCTCCTTCACCCGCTA -> GGAGCTCCTTCACCCGCTAG
AGCCAATGGGTGACGTTGGC -> GCCAATGGGTGACGTTGGCG
CGCGCGACGTGTATGGTATG -> GCGCGACGTGTATGGTATGG
GATGCGCACTGCGGAACTAG -> ATGCGCACTGCGGAACTAGA
TTGGCGAACACCGCGACTGC -> TGGCGAACACCGCGACTGCC
AGTAACTTTTCGCTCGGTAC -> GTAACTTTTCGCTCGGTACA
GGTTCCACTATGCCAATAAG -> GTTCCACTATGCCAATAAGA
CAATGTAGTTGCAGCTAGTA -> AATGTAGTTGCAGCTAGTAC
TCGTTGCTCCTCTCGAGCGG -> CGTTGCTCCTCTCGAGCGGA
ATGTTCCCCACATCGACTCC -> TGTTCCCCACATCGACTCCG
ATTCCGACCTCCAGGTTGAC -> TTCCGACCTCCAGGTTGACC
GGCTTCCAGTCGGAGGACTT -> GCTTCCAGTCGGAGGACTTT
CGAGCGGACTGCAGGAACTC -> GAGCGGACTGCAGGAACTCT
GCCATCACCTCGCATAGGTA -> CCATCACCTCGCATAGGTAT
CACTATTTTGGCCAGTTCAA -> ACTATTTTGGCCAGTTCAAA
AGCTACAGAGAGTGCTACAA -> GCTACAGAGAGTGCTACAAT
TACATGCTCTCTTGTTTGTC -> ACATGCTCTCTTGTTTGTCA
GAGGTTAATCTGGACCCTGA -> AGGTTAATCTGGACCCTGAT
GGTGTTGTGTGGCTGGGCGT -> GTGTTGTGTGGCTGGGCGTG
TTCAAATCTTAATAGTCACT -> TCAAATCTTAATAGTCACTC
GAGTAACTTTTCGCTCGGTA -> AGTAACTTTTCGCTCGGTAC
GCTTCCAGTCGGAGGACTTT -> CTTCCAGTCGGAGGACTTTT
CTAGAACATTGGCTTATTCC -> TAGAACATTGGCTTATTCCG
ACCTTCGTAGGAGTTCCAGA -> CCTTCGTAGGAGTTCCAGAC
GTACATGCTCTCTTGTTTGT -> TACATGCTCTCTTGTTTGTC
CTTTTCGCTCGGTACATGCT -> TTTTCGCTCGGTACATGCTC
GCGGCCCGGCACGTGCTTAT -> CGGCCCGGCACGTGCTTATT
GACGTTGGCGAACACCGCGA -> ACGTTGGCGAACACCGCGAC
AAACGCGAGTGCCTATATTA -> AACGCGAGTGCCTATATTAC
TGCCTGATCAATGTGTTGGT -> GCCTGATCAATGTGTTGGTG
CGCTAGTAGCACAGACAACA -> GCTAGTAGCACAGACAACAG
CGGCACGTGCTTATTTCGAA -> GGCACGTGCTTATTTCGAAT
GGACTTTTGAGTGACCTTGA -> GACTTTTGAGTGACCTTGAG
AGACGGTGCGAGGCGGACCC -> GACGGTGCGAGGCGGACCCA
GCGACGTGTATGGTATGGAA -> CGACGTGTATGGTATGGAAT
TCTTGCGCGAAAGAACCGTT -> CTTGCGCGAAAGAACCGTTT
GACCTTCGTAGGAGTTCCAG -> ACCTTCGTAGGAGTTCCAGA
ATCAGAACTCGAGGGGGGCT -> TCAGAACTCGAGGGGGGCTT
TCAGCTACAGAGAGTGCTAC -> CAGCTACAGAGAGTGCTACA
CACTCCATCCGGCTCTGGGC -> ACTCCATCCGGCTCTGGGCA
AAAAGGGCACGAAAGGTTTT -> AAAGGGCACGAAAGGTTTTA
AAAGGTTTTAAAGTTAGCGG -> AAGGTTTTAAAGTTAGCGGA
ACAGTCTACGGGCCATCACC -> CAGTCTACGGGCCATCACCT
AGAGAGTGCTACAATGGCCC -> GAGAGTGCTACAATGGCCCT
CACAGACAACAGTCGGTTCT -> ACAGACAACAGTCGGTTCTT
TGAGTGACCTTGAGTGGAGG -> GAGTGACCTTGAGTGGAGGT
CACCCGCTAGTAGCACAGAC -> ACCCGCTAGTAGCACAGACA
GCCTGATCAATGTGTTGGTG -> CCTGATCAATGTGTTGGTGG
CTCGGTACATGCTCTCTTGT -> TCGGTACATGCTCTCTTGTT
GGCAAGAATCCCTGATATGT -> GCAAGAATCCCTGATATGTG
TTCTTGCGCGAAAGAACCGT -> TCTTGCGCGAAAGAACCGTT
CGGTGCGAGGCGGACCCAAT -> GGTGCGAGGCGGACCCAATG
CAGTTGTTGCGCTCCTGGTT -> AGTTGTTGCGCTCCTGGTTA
TTGCAGCTAGTACCAGGAAA -> TGCAGCTAGTACCAGGAAAT
TGTGCGGCCCGGCACGTGCT -> GTGCGGCCCGGCACGTGCTT
ACCCAATGTAGTTGCAGCTA -> CCCAATGTAGTTGCAGCTAG
CCAATGTAGTTGCAGCTAGT -> CAATGTAGTTGCAGCTAGTA
TTCCAGTCGGAGGACTTTTG -> TCCAGTCGGAGGACTTTTGA
GAGTGCTACAATGGCCCTAT -> AGTGCTACAATGGCCCTATA
CTCACTTGGTTCCACTATGC -> TCACTTGGTTCCACTATGCC
TGTTGGTGGCACTATTTTGG -> GTTGGTGGCACTATTTTGGC
TCGCTCGGTACATGCTCTCT -> CGCTCGGTACATGCTCTCTT
ACTGCCCTCTCTAGAGTGAG -> CTGCCCTCTCTAGAGTGAGA
ACCAAAAAAAGGGCACGAAA -> CCAAAAAAAGGGCACGAAAG
GGCGATGCGCACTGCGGAAC -> GCGATGCGCACTGCGGAACT
CTTTTGAGTGACCTTGAGTG -> TTTTGAGTGACCTTGAGTGG
GTTAGCGGAGCTCCTTCACC -> TTAGCGGAGCTCCTTCACCC
TTGGTTCCACTATGCCAATA -> TGGTTCCACTATGCCAATAA
CCCGGCACGTGCTTATTTCG -> CCGGCACGTGCTTATTTCGA
GTATCATACATGCGCGCGAC -> TATCATACATGCGCGCGACG
GCGCACTGCGGAACTAGAGT -> CGCACTGCGGAACTAGAGTC
AGGGGTTTGTGTATCAGAAC -> GGGGTTTGTGTATCAGAACT
GCACGAAAGGTTTTAAAGTT -> CACGAAAGGTTTTAAAGTTA
TTTGCCCGTGGCTTCCAGTC -> TTGCCCGTGGCTTCCAGTCG
GACTAGAACATTGGCTTATT -> ACTAGAACATTGGCTTATTC
ACTCCGTGCCTGTATCCAGA -> CTCCGTGCCTGTATCCAGAG
CCTGCACGGTGTTGTGTGGC -> CTGCACGGTGTTGTGTGGCT
AATCCCGTGGATTGCCTGAT -> ATCCCGTGGATTGCCTGATC
GTGGCACTATTTTGGCCAGT -> TGGCACTATTTTGGCCAGTT
GCGCGACGTGTATGGTATGG -> CGCGACGTGTATGGTATGGA
CGCACTGCGGAACTAGAGTC -> GCACTGCGGAACTAGAGTCG
GAGCGGACTGCAGGAACTCT -> AGCGGACTGCAGGAACTCTC
CCATCCGGCTCTGGGCAAGA -> CATCCGGCTCTGGGCAAGAA
AGGAACTCTCACTTGGTTCC -> GGAACTCTCACTTGGTTCCA
GTATCCAGAGTAACTTTTCG -> TATCCAGAGTAACTTTTCGC
TTCGTTGCTCCTCTCGAGCG -> TCGTTGCTCCTCTCGAGCGG
GGCGGACCCAATGTAGTTGC -> GCGGACCCAATGTAGTTGCA
AATTTACCGAGGTTAATCTG -> ATTTACCGAGGTTAATCTGG
CGATGCGCACTGCGGAACTA -> GATGCGCACTGCGGAACTAG
TTCAGCTACAGAGAGTGCTA -> TCAGCTACAGAGAGTGCTAC
AATTAGAGCCAATGGGTGAC -> ATTAGAGCCAATGGGTGACG
TTTAAAGTTAGCGGAGCTCC -> TTAAAGTTAGCGGAGCTCCT
CAGAGTAACTTTTCGCTCGG -> AGAGTAACTTTTCGCTCGGT
ATGTAGTTGCAGCTAGTACC -> TGTAGTTGCAGCTAGTACCA
ACAGACAACAGTCGGTTCTT -> CAGACAACAGTCGGTTCTTG
TCCTCTCGAGCGGACTGCAG -> CCTCTCGAGCGGACTGCAGG
CCCTGGTTGCTATGCGACTA -> CCTGGTTGCTATGCGACTAG
AGTTCAAATCTTAATAGTCA -> GTTCAAATCTTAATAGTCAC
GCGACTAGAACATTGGCTTA -> CGACTAGAACATTGGCTTAT
TTTCGCTCGGTACATGCTCT -> TTCGCTCGGTACATGCTCTC
ATGCGCGCGACGTGTATGGT -> TGCGCGCGACGTGTATGGTA
ACTCCATCCGGCTCTGGGCA -> CTCCATCCGGCTCTGGGCAA
TTAGAGCCAATGGGTGACGT -> TAGAGCCAATGGGTGACGTT
CTATTCGTGTGCGGCCCGGC -> TATTCGTGTGCGGCCCGGCA
GTACCAGGAAATCCCCTGCA -> TACCAGGAAATCCCCTGCAC
TGGTATGGAATTAGAGCCAA -> GGTATGGAATTAGAGCCAAT
GTTGCAGCTAGTACCAGGAA -> TTGCAGCTAGTACCAGGAAA
ACGGGCCATCACCTCGCATA -> CGGGCCATCACCTCGCATAG
CGACCTCCAGGTTGACCGTA -> GACCTCCAGGTTGACCGTAT
TAGTACCAGGAAATCCCCTG -> AGTACCAGGAAATCCCCTGC
AGGGCACGAAAGGTTTTAAA -> GGGCACGAAAGGTTTTAAAG
CTCTCACTTGGTTCCACTAT -> TCTCACTTGGTTCCACTATG
GCCAATAAGAAACGCGAGTG -> CCAATAAGAAACGCGAGTGC
AGGTTGACCGTATCATACAT -> GGTTGACCGTATCATACATG
CGGACTGCAGGAACTCTCAC -> GGACTGCAGGAACTCTCACT
GCGAGTGCCTATATTACGGA -> CGAGTGCCTATATTACGGAG
TTGTTTGTCAAGGGACCAAA -> TGTTTGTCAAGGGACCAAAA
TCCAGAGTAACTTTTCGCTC -> CCAGAGTAACTTTTCGCTCG
AATCCCTGATATGTGCAGGT -> ATCCCTGATATGTGCAGGTC
GCGCGTAGGGGTTTGTGTAT -> CGCGTAGGGGTTTGTGTATC
ATGTGTTGGTGGCACTATTT -> TGTGTTGGTGGCACTATTTT
CCCTGATATGTGCAGGTCCA -> CCTGATATGTGCAGGTCCAA
AGCACAGACAACAGTCGGTT -> GCACAGACAACAGTCGGTTC
AGAAACGCGAGTGCCTATAT -> GAAACGCGAGTGCCTATATT
CCGAGGTTAATCTGGACCCT -> CGAGGTTAATCTGGACCCTG
TTCCACTATGCCAATAAGAA -> TCCACTATGCCAATAAGAAA
TTCCGACCTCCAGGTTGACC -> TCCGACCTCCAGGTTGACCG
CAAAAAAAGGGCACGAAAGG -> AAAAAAAGGGCACGAAAGGT
GCGGAGCTCCTTCACCCGCT -> CGGAGCTCCTTCACCCGCTA
GCAGGAACTCTCACTTGGTT -> CAGGAACTCTCACTTGGTTC
GAATTAGAGCCAATGGGTGA -> AATTAGAGCCAATGGGTGAC
CTTATACATCGTGCTCCCAA -> TTATACATCGTGCTCCCAAT
TCACGACCTTCGTAGGAGTT -> CACGACCTTCGTAGGAGTTC
GGGTGACGTTGGCGAACACC -> GGTGACGTTGGCGAACACCG
TATGTTCCCCACATCGACTC -> ATGTTCCCCACATCGACTCC
TTAATAGTCACTCCATCCGG -> TAATAGTCACTCCATCCGGC
AGTACCAGGAAATCCCCTGC -> GTACCAGGAAATCCCCTGCA
ACATGCTCTCTTGTTTGTCA -> CATGCTCTCTTGTTTGTCAA
CGCTCCTGGTTACTTATACA -> GCTCCTGGTTACTTATACAT
GGAGCTCCTTCACCCGCTAG -> GAGCTCCTTCACCCGCTAGT
GTGCCTGTATCCAGAGTAAC -> TGCCTGTATCCAGAGTAACT
CAGGTCCAAGACAGTCTACG -> AGGTCCAAGACAGTCTACGG
TCTATTCGTGTGCGGCCCGG -> CTATTCGTGTGCGGCCCGGC
TGGCGATGCGCACTGCGGAA -> GGCGATGCGCACTGCGGAAC
AACTCTCACTTGGTTCCACT -> ACTCTCACTTGGTTCCACTA
GGAGGACTTTTGAGTGACCT -> GAGGACTTTTGAGTGACCTT
CGACGTGTATGGTATGGAAT -> GACGTGTATGGTATGGAATT
GAGTGGAGGTGGCGATGCGC -> AGTGGAGGTGGCGATGCGCA
GTGCTTATTTCGAATCACGA -> TGCTTATTTCGAATCACGAC
ACAATGGCCCTATAAGGTTT -> CAATGGCCCTATAAGGTTTA
CGCGACGTGTATGGTATGGA -> GCGACGTGTATGGTATGGAA
ATTCGTGTGCGGCCCGGCAC -> TTCGTGTGCGGCCCGGCACG
TGGTTACTTATACATCGTGC -> GGTTACTTATACATCGTGCT
AGGGACCAAAAAAAGGGCAC -> GGGACCAAAAAAAGGGCACG
TACGGGCCATCACCTCGCAT -> ACGGGCCATCACCTCGCATA
ACGAAAGGTTTTAAAGTTAG -> CGAAAGGTTTTAAAGTTAGC
GTATGGAATTAGAGCCAATG -> TATGGAATTAGAGCCAATGG
GTGTGCGGCCCGGCACGTGC -> TGTGCGGCCCGGCACGTGCT
CACTGCGGAACTAGAGTCGA -> ACTGCGGAACTAGAGTCGAT
TAGCAACTTGCGCGTAGGGG -> AGCAACTTGCGCGTAGGGGT
AAGCATGGCATCTCCCCTAG -> AGCATGGCATCTCCCCTAGT
CCATCACCTCGCATAGGTAT -> CATCACCTCGCATAGGTATA
GACGTGTATGGTATGGAATT -> ACGTGTATGGTATGGAATTA
ATGGTATGGAATTAGAGCCA -> TGGTATGGAATTAGAGCCAA
ACTATGCCAATAAGAAACGC -> CTATGCCAATAAGAAACGCG
CTAGAGTCGATAGGTACTAA -> TAGAGTCGATAGGTACTAAT
GAGGACTTTTGAGTGACCTT -> AGGACTTTTGAGTGACCTTG
TTATTCCGACCTCCAGGTTG -> TATTCCGACCTCCAGGTTGA
TTGTCAAGGGACCAAAAAAA -> TGTCAAGGGACCAAAAAAAG
TGCGACTAGAACATTGGCTT -> GCGACTAGAACATTGGCTTA
TCGGTACATGCTCTCTTGTT -> CGGTACATGCTCTCTTGTTT
TCCAGTCGGAGGACTTTTGA -> CCAGTCGGAGGACTTTTGAG
TGACGTTGGCGAACACCGCG -> GACGTTGGCGAACACCGCGA
GGACTGCAGGAACTCTCACT -> GACTGCAGGAACTCTCACTT
CAATAAGAAACGCGAGTGCC -> AATAAGAAACGCGAGTGCCT
TTAAAGTTAGCGGAGCTCCT -> TAAAGTTAGCGGAGCTCCTT
CGCGTAGGGGTTTGTGTATC -> GCGTAGGGGTTTGTGTATCA
GTGCAGGTCCAAGACAGTCT -> TGCAGGTCCAAGACAGTCTA
CGAACACCGCGACTGCCCTC -> GAACACCGCGACTGCCCTCT
CCTGGTTACTTATACATCGT -> CTGGTTACTTATACATCGTG
CTCGCATAGGTATAATTTAC -> TCGCATAGGTATAATTTACC
GACAGTCTACGGGCCATCAC -> ACAGTCTACGGGCCATCACC
CGTGTATGGTATGGAATTAG -> GTGTATGGTATGGAATTAGA
GCTATGCGACTAGAACATTG -> CTATGCGACTAGAACATTGG
GCGAACACCGCGACTGCCCT -> CGAACACCGCGACTGCCCTC
GTAACTTTTCGCTCGGTACA -> TAACTTTTCGCTCGGTACAT
CAATGGCCCTATAAGGTTTA -> AATGGCCCTATAAGGTTTAT
ATCTTAATAGTCACTCCATC -> TCTTAATAGTCACTCCATCC
AGAGTCGATAGGTACTAATG -> GAGTCGATAGGTACTAATGA
TCCTGGTTACTTATACATCG -> CCTGGTTACTTATACATCGT
TGAGTGGAGGTGGCGATGCG -> GAGTGGAGGTGGCGATGCGC
TAGAGTGAGATACCAGATTC -> AGAGTGAGATACCAGATTCC
GATTGCCTGATCAATGTGTT -> ATTGCCTGATCAATGTGTTG
AGGTGGCGATGCGCACTGCG -> GGTGGCGATGCGCACTGCGG
GCGTAGGGGTTTGTGTATCA -> CGTAGGGGTTTGTGTATCAG
ACATCGTGCTCCCAATGGGC -> CATCGTGCTCCCAATGGGCG
CTGGACCCTGATTCCCTGGT -> TGGACCCTGATTCCCTGGTT
ACGTTGGCGAACACCGCGAC -> CGTTGGCGAACACCGCGACT
TCCGGCTCTGGGCAAGAATC -> CCGGCTCTGGGCAAGAATCC
TGGCTTCCAGTCGGAGGACT -> GGCTTCCAGTCGGAGGACTT
TATGCGACTAGAACATTGGC -> ATGCGACTAGAACATTGGCT
AACGCGAGTGCCTATATTAC -> ACGCGAGTGCCTATATTACG
GGTTGCTATGCGACTAGAAC -> GTTGCTATGCGACTAGAACA
CCCCTAGTCTATTCGTGTGC -> CCCTAGTCTATTCGTGTGCG
TCATACATGCGCGCGACGTG -> CATACATGCGCGCGACGTGT
TGGCATCTCCCCTAGTCTAT -> GGCATCTCCCCTAGTCTATT
TTTGGCCAGTTCAAATCTTA -> TTGGCCAGTTCAAATCTTAA
CCAGATTCCTTGGCAGTTGT -> CAGATTCCTTGGCAGTTGTT
AGTGACCTTGAGTGGAGGTG -> GTGACCTTGAGTGGAGGTGG
ATGATAGCAACTTGCGCGTA -> TGATAGCAACTTGCGCGTAG
GAAATCCCCTGCACGGTGTT -> AAATCCCCTGCACGGTGTTG
CGATAAGCATCAATTTGCCC -> GATAAGCATCAATTTGCCCG
CCCAATGTAGTTGCAGCTAG -> CCAATGTAGTTGCAGCTAGT
GTGGAGGTGGCGATGCGCAC -> TGGAGGTGGCGATGCGCACT
GGTCCAAGACAGTCTACGGG -> GTCCAAGACAGTCTACGGGC
CCAGAGTAACTTTTCGCTCG -> CAGAGTAACTTTTCGCTCGG
CGGTGTTGTGTGGCTGGGCG -> GGTGTTGTGTGGCTGGGCGT
CCACATCGACTCCGTGCCTG -> CACATCGACTCCGTGCCTGT
TGTAGTTGCAGCTAGTACCA -> GTAGTTGCAGCTAGTACCAG
TGTTGCGCTCCTGGTTACTT -> GTTGCGCTCCTGGTTACTTA
AGTGCTACAATGGCCCTATA -> GTGCTACAATGGCCCTATAA
GAACTCGAGGGGGGCTTAGA -> AACTCGAGGGGGGCTTAGAT
CCGTGCCTGTATCCAGAGTA -> CGTGCCTGTATCCAGAGTAA
GGCACGTGCTTATTTCGAAT -> GCACGTGCTTATTTCGAATC
TTCCCCACATCGACTCCGTG -> TCCCCACATCGACTCCGTGC
CTATGCGACTAGAACATTGG -> TATGCGACTAGAACATTGGC
GATACCAGATTCCTTGGCAG -> ATACCAGATTCCTTGGCAGT
AATCCCCTGCACGGTGTTGT -> ATCCCCTGCACGGTGTTGTG
TACATCGTGCTCCCAATGGG -> ACATCGTGCTCCCAATGGGC
GTGGATTGCCTGATCAATGT -> TGGATTGCCTGATCAATGTG
TCAAGGGACCAAAAAAAGGG -> CAAGGGACCAAAAAAAGGGC
TGCGGAACTAGAGTCGATAG -> GCGGAACTAGAGTCGATAGG
TCAATTTGCCCGTGGCTTCC -> CAATTTGCCCGTGGCTTCCA
AGCTAGTACCAGGAAATCCC -> GCTAGTACCAGGAAATCCCC
ATCACGACCTTCGTAGGAGT -> TCACGACCTTCGTAGGAGTT
ATTTGCCCGTGGCTTCCAGT -> TTTGCCCGTGGCTTCCAGTC
AATGTAGTTGCAGCTAGTAC -> ATGTAGTTGCAGCTAGTACC
CACCGCGACTGCCCTCTCTA -> ACCGCGACTGCCCTCTCTAG
GTCCAAGACAGTCTACGGGC -> TCCAAGACAGTCTACGGGCC
TGGCCAGTTCAAATCTTAAT -> GGCCAGTTCAAATCTTAATA
TGTGTGGCTGGGCGTGCTTC -> GTGTGGCTGGGCGTGCTTCA
TAAAGTTAGCGGAGCTCCTT -> AAAGTTAGCGGAGCTCCTTC
TGCGCACTGCGGAACTAGAG -> GCGCACTGCGGAACTAGAGT
TATTTTGGCCAGTTCAAATC -> ATTTTGGCCAGTTCAAATCT
TAGAGTCGATAGGTACTAAT -> AGAGTCGATAGGTACTAATG
CGTGGATTGCCTGATCAATG -> GTGGATTGCCTGATCAATGT
CGTTGGCGAACACCGCGACT -> GTTGGCGAACACCGCGACTG
CATCACCTCGCATAGGTATA -> ATCACCTCGCATAGGTATAA
CTACGGGCCATCACCTCGCA -> TACGGGCCATCACCTCGCAT
TATTCGTGTGCGGCCCGGCA -> ATTCGTGTGCGGCCCGGCAC
ATCACCTCGCATAGGTATAA -> TCACCTCGCATAGGTATAAT
GACTGCCCTCTCTAGAGTGA -> ACTGCCCTCTCTAGAGTGAG
CGAATCACGACCTTCGTAGG -> GAATCACGACCTTCGTAGGA
GGTACTAATGATAGCAACTT -> GTACTAATGATAGCAACTTG
TTTTCGCTCGGTACATGCTC -> TTTCGCTCGGTACATGCTCT
TGCTCCTCTCGAGCGGACTG -> GCTCCTCTCGAGCGGACTGC
GTTCCAGACGGTGCGAGGCG -> TTCCAGACGGTGCGAGGCGG
CTCTAGAGTGAGATACCAGA -> TCTAGAGTGAGATACCAGAT
AAAGGGCACGAAAGGTTTTA -> AAGGGCACGAAAGGTTTTAA
GAGATACCAGATTCCTTGGC -> AGATACCAGATTCCTTGGCA
CTCCTGGTTACTTATACATC -> TCCTGGTTACTTATACATCG
TTGTGTGGCTGGGCGTGCTT -> TGTGTGGCTGGGCGTGCTTC
CCAGACGGTGCGAGGCGGAC -> CAGACGGTGCGAGGCGGACC
TTTTGATGAATCCCGTGGAT -> TTTGATGAATCCCGTGGATT
GTTGGCGAACACCGCGACTG -> TTGGCGAACACCGCGACTGC
GATCAATGTGTTGGTGGCAC -> ATCAATGTGTTGGTGGCACT
CTTCAGCTACAGAGAGTGCT -> TTCAGCTACAGAGAGTGCTA
TATAAGGTTTATGTTCCCCA -> ATAAGGTTTATGTTCCCCAC
AATGGCCCTATAAGGTTTAT -> ATGGCCCTATAAGGTTTATG
CTGCAGGAACTCTCACTTGG -> TGCAGGAACTCTCACTTGGT
GTTCAAATCTTAATAGTCAC -> TTCAAATCTTAATAGTCACT
CTAGTACCAGGAAATCCCCT -> TAGTACCAGGAAATCCCCTG
CCCTAGTCTATTCGTGTGCG -> CCTAGTCTATTCGTGTGCGG
CTGGGCAAGAATCCCTGATA -> TGGGCAAGAATCCCTGATAT
TGCAGGAACTCTCACTTGGT -> GCAGGAACTCTCACTTGGTT
GTTTGTCAAGGGACCAAAAA -> TTTGTCAAGGGACCAAAAAA
CTGCCCTCTCTAGAGTGAGA -> TGCCCTCTCTAGAGTGAGAT
CAGGAACTCTCACTTGGTTC -> AGGAACTCTCACTTGGTTCC
GCTTATTCCGACCTCCAGGT -> CTTATTCCGACCTCCAGGTT
TAGAACATTGGCTTATTCCG -> AGAACATTGGCTTATTCCGA
GCTTATTTCGAATCACGACC -> CTTATTTCGAATCACGACCT
CCGTGGATTGCCTGATCAAT -> CGTGGATTGCCTGATCAATG
TAGTTGCAGCTAGTACCAGG -> AGTTGCAGCTAGTACCAGGA
TGCGGCCCGGCACGTGCTTA -> GCGGCCCGGCACGTGCTTAT
GACGGTGCGAGGCGGACCCA -> ACGGTGCGAGGCGGACCCAA
ATGGCCCTATAAGGTTTATG -> TGGCCCTATAAGGTTTATGT
GAGTGCCTATATTACGGAGG -> AGTGCCTATATTACGGAGGG
TGGGTGACGTTGGCGAACAC -> GGGTGACGTTGGCGAACACC
GTTGTTGCGCTCCTGGTTAC -> TTGTTGCGCTCCTGGTTACT
GTTGCGCTCCTGGTTACTTA -> TTGCGCTCCTGGTTACTTAT
GCCAGTTCAAATCTTAATAG -> CCAGTTCAAATCTTAATAGT
CTCGAGGGGGGCTTAGATTC -> TCGAGGGGGGCTTAGATTCG
TGGCACTATTTTGGCCAGTT -> GGCACTATTTTGGCCAGTTC
GGTTTTAAAGTTAGCGGAGC -> GTTTTAAAGTTAGCGGAGCT
TGTATGGTATGGAATTAGAG -> GTATGGTATGGAATTAGAGC
CATCGTGCTCCCAATGGGCG -> ATCGTGCTCCCAATGGGCGA
CGCGAAAGAACCGTTTTGAT -> GCGAAAGAACCGTTTTGATG
ACATGCGCGCGACGTGTATG -> CATGCGCGCGACGTGTATGG
AACTTTTCGCTCGGTACATG -> ACTTTTCGCTCGGTACATGC
ACAGAGAGTGCTACAATGGC -> CAGAGAGTGCTACAATGGCC
TGAGATACCAGATTCCTTGG -> GAGATACCAGATTCCTTGGC
TCCGTGCCTGTATCCAGAGT -> CCGTGCCTGTATCCAGAGTA
CCAATAAGAAACGCGAGTGC -> CAATAAGAAACGCGAGTGCC
CGACTAGAACATTGGCTTAT -> GACTAGAACATTGGCTTATT
TTCGCTCGGTACATGCTCTC -> TCGCTCGGTACATGCTCTCT
TCCGACCTCCAGGTTGACCG -> CCGACCTCCAGGTTGACCGT
CTATAAGGTTTATGTTCCCC -> TATAAGGTTTATGTTCCCCA
GTGCTACAATGGCCCTATAA -> TGCTACAATGGCCCTATAAG
TACTTATACATCGTGCTCCC -> ACTTATACATCGTGCTCCCA
CCAGTTCAAATCTTAATAGT -> CAGTTCAAATCTTAATAGTC
CGAGTGCCTATATTACGGAG -> GAGTGCCTATATTACGGAGG
GTTGACCGTATCATACATGC -> TTGACCGTATCATACATGCG
GTCTATTCGTGTGCGGCCCG -> TCTATTCGTGTGCGGCCCGG
TGAATCCCGTGGATTGCCTG -> GAATCCCGTGGATTGCCTGA
GGGGGGCTTAGATTCGTTGC -> GGGGGCTTAGATTCGTTGCT
TGTCAAGGGACCAAAAAAAG -> GTCAAGGGACCAAAAAAAGG
ATCCCTGATATGTGCAGGTC -> TCCCTGATATGTGCAGGTCC
GACTGCAGGAACTCTCACTT -> ACTGCAGGAACTCTCACTTG
GAGGGGGGCTTAGATTCGTT -> AGGGGGGCTTAGATTCGTTG
CCAAAAAAAGGGCACGAAAG -> CAAAAAAAGGGCACGAAAGG
CCGTGGCTTCCAGTCGGAGG -> CGTGGCTTCCAGTCGGAGGA
TCAGAACTCGAGGGGGGCTT -> CAGAACTCGAGGGGGGCTTA
CGTAGGAGTTCCAGACGGTG -> GTAGGAGTTCCAGACGGTGC
TAGATTCGTTGCTCCTCTCG -> AGATTCGTTGCTCCTCTCGA
GCTTAGATTCGTTGCTCCTC -> CTTAGATTCGTTGCTCCTCT
CCCACATCGACTCCGTGCCT -> CCACATCGACTCCGTGCCTG
CTTCCAGTCGGAGGACTTTT -> TTCCAGTCGGAGGACTTTTG
AAGGTTTTAAAGTTAGCGGA -> AGGTTTTAAAGTTAGCGGAG
AGCATCAATTTGCCCGTGGC -> GCATCAATTTGCCCGTGGCT
TGGCCCTATAAGGTTTATGT -> GGCCCTATAAGGTTTATGTT
GAGGCGGACCCAATGTAGTT -> AGGCGGACCCAATGTAGTTG
CTGGTTGCTATGCGACTAGA -> TGGTTGCTATGCGACTAGAA
TGGTTCCACTATGCCAATAA -> GGTTCCACTATGCCAATAAG
CCGCGACTGCCCTCTCTAGA -> CGCGACTGCCCTCTCTAGAG
CTATTTTGGCCAGTTCAAAT -> TATTTTGGCCAGTTCAAATC
GCTACAGAGAGTGCTACAAT -> CTACAGAGAGTGCTACAATG
TCTCTTGTTTGTCAAGGGAC -> CTCTTGTTTGTCAAGGGACC
AATGTGTTGGTGGCACTATT -> ATGTGTTGGTGGCACTATTT
AGTCGGAGGACTTTTGAGTG -> GTCGGAGGACTTTTGAGTGA
ATCCAGAGTAACTTTTCGCT -> TCCAGAGTAACTTTTCGCTC
AAGAAACGCGAGTGCCTATA -> AGAAACGCGAGTGCCTATAT
CTCCTCTCGAGCGGACTGCA -> TCCTCTCGAGCGGACTGCAG
CGTGCCTGTATCCAGAGTAA -> GTGCCTGTATCCAGAGTAAC
GTGGCTGGGCGTGCTTCAGC -> TGGCTGGGCGTGCTTCAGCT
TCCAAGACAGTCTACGGGCC -> CCAAGACAGTCTACGGGCCA
CGTGCTCCCAATGGGCGATA -> GTGCTCCCAATGGGCGATAA
GGCGTGCTTCAGCTACAGAG -> GCGTGCTTCAGCTACAGAGA
AGTTGTTGCGCTCCTGGTTA -> GTTGTTGCGCTCCTGGTTAC
ATAGCAACTTGCGCGTAGGG -> TAGCAACTTGCGCGTAGGGG
GCGGAACTAGAGTCGATAGG -> CGGAACTAGAGTCGATAGGT
GTGGCGATGCGCACTGCGGA -> TGGCGATGCGCACTGCGGAA
CATACATGCGCGCGACGTGT -> ATACATGCGCGCGACGTGTA
TCTCTAGAGTGAGATACCAG -> CTCTAGAGTGAGATACCAGA
AAGACAGTCTACGGGCCATC -> AGACAGTCTACGGGCCATCA
GGACCAAAAAAAGGGCACGA -> GACCAAAAAAAGGGCACGAA
CAGGTTGACCGTATCATACA -> AGGTTGACCGTATCATACAT
TCTTAATAGTCACTCCATCC -> CTTAATAGTCACTCCATCCG
TCCACTATGCCAATAAGAAA -> CCACTATGCCAATAAGAAAC
CTATGCCAATAAGAAACGCG -> TATGCCAATAAGAAACGCGA
AGGTACTAATGATAGCAACT -> GGTACTAATGATAGCAACTT
TACATGCGCGCGACGTGTAT -> ACATGCGCGCGACGTGTATG
CCAATGGGCGATAAGCATCA -> CAATGGGCGATAAGCATCAA
CACGGTGTTGTGTGGCTGGG -> ACGGTGTTGTGTGGCTGGGC
AACATTGGCTTATTCCGACC -> ACATTGGCTTATTCCGACCT
AGAACTCGAGGGGGGCTTAG -> GAACTCGAGGGGGGCTTAGA
GACCGTATCATACATGCGCG -> ACCGTATCATACATGCGCGC
ATCCGGCTCTGGGCAAGAAT -> TCCGGCTCTGGGCAAGAATC
TGGCGAACACCGCGACTGCC -> GGCGAACACCGCGACTGCCC
TAGCGGAGCTCCTTCACCCG -> AGCGGAGCTCCTTCACCCGC
TCGACTCCGTGCCTGTATCC -> CGACTCCGTGCCTGTATCCA
CGGCTCTGGGCAAGAATCCC -> GGCTCTGGGCAAGAATCCCT
ATGGGTGACGTTGGCGAACA -> TGGGTGACGTTGGCGAACAC
ATGCGCACTGCGGAACTAGA -> TGCGCACTGCGGAACTAGAG
CAGGAAATCCCCTGCACGGT -> AGGAAATCCCCTGCACGGTG
TCTACGGGCCATCACCTCGC -> CTACGGGCCATCACCTCGCA
CGTGTGCGGCCCGGCACGTG -> GTGTGCGGCCCGGCACGTGC
CCAGTCGGAGGACTTTTGAG -> CAGTCGGAGGACTTTTGAGT
GTCGGTTCTTGCGCGAAAGA -> TCGGTTCTTGCGCGAAAGAA
TCTAGAGTGAGATACCAGAT -> CTAGAGTGAGATACCAGATT
CTCCCCTAGTCTATTCGTGT -> TCCCCTAGTCTATTCGTGTG
GGGCCATCACCTCGCATAGG -> GGCCATCACCTCGCATAGGT
GACCTCCAGGTTGACCGTAT -> ACCTCCAGGTTGACCGTATC
GCTAGTACCAGGAAATCCCC -> CTAGTACCAGGAAATCCCCT
TTGAGTGGAGGTGGCGATGC -> TGAGTGGAGGTGGCGATGCG
GCACGGTGTTGTGTGGCTGG -> CACGGTGTTGTGTGGCTGGG
AAGCATCAATTTGCCCGTGG -> AGCATCAATTTGCCCGTGGC
CCTCTCGAGCGGACTGCAGG -> CTCTCGAGCGGACTGCAGGA
CACTTGGTTCCACTATGCCA -> ACTTGGTTCCACTATGCCAA
CCTCTCTAGAGTGAGATACC -> CTCTCTAGAGTGAGATACCA
ACTAGAACATTGGCTTATTC -> CTAGAACATTGGCTTATTCC
TGATGAATCCCGTGGATTGC -> GATGAATCCCGTGGATTGCC
GGTTTATGTTCCCCACATCG -> GTTTATGTTCCCCACATCGA
TTCACCCGCTAGTAGCACAG -> TCACCCGCTAGTAGCACAGA
GTGTGGCTGGGCGTGCTTCA -> TGTGGCTGGGCGTGCTTCAG
AGAGTGCTACAATGGCCCTA -> GAGTGCTACAATGGCCCTAT
TGGGCGTGCTTCAGCTACAG -> GGGCGTGCTTCAGCTACAGA
GCCTGTATCCAGAGTAACTT -> CCTGTATCCAGAGTAACTTT
GCGGACCCAATGTAGTTGCA -> CGGACCCAATGTAGTTGCAG
CTCGAGCGGACTGCAGGAAC -> TCGAGCGGACTGCAGGAACT
CAACAGTCGGTTCTTGCGCG -> AACAGTCGGTTCTTGCGCGA
TCCTTCACCCGCTAGTAGCA -> CCTTCACCCGCTAGTAGCAC
GTATCAGAACTCGAGGGGGG -> TATCAGAACTCGAGGGGGGC
ACAACAGTCGGTTCTTGCGC -> CAACAGTCGGTTCTTGCGCG
AGGGGGGCTTAGATTCGTTG -> GGGGGGCTTAGATTCGTTGC
GCACAGACAACAGTCGGTTC -> CACAGACAACAGTCGGTTCT
ATTTTGGCCAGTTCAAATCT -> TTTTGGCCAGTTCAAATCTT
AAAGAACCGTTTTGATGAAT -> AAGAACCGTTTTGATGAATC
ATTGCCTGATCAATGTGTTG -> TTGCCTGATCAATGTGTTGG
TTACCGAGGTTAATCTGGAC -> TACCGAGGTTAATCTGGACC
GCTACAATGGCCCTATAAGG -> CTACAATGGCCCTATAAGGT
GTTTATGTTCCCCACATCGA -> TTTATGTTCCCCACATCGAC
AGTCGATAGGTACTAATGAT -> GTCGATAGGTACTAATGATA
GGTATAATTTACCGAGGTTA -> GTATAATTTACCGAGGTTAA
GTGTTGGTGGCACTATTTTG -> TGTTGGTGGCACTATTTTGG
GGCCAGTTCAAATCTTAATA -> GCCAGTTCAAATCTTAATAG
GGACCCAATGTAGTTGCAGC -> GACCCAATGTAGTTGCAGCT
ACCTCCAGGTTGACCGTATC -> CCTCCAGGTTGACCGTATCA
TGGACCCTGATTCCCTGGTT -> GGACCCTGATTCCCTGGTTG
TATGGTATGGAATTAGAGCC -> ATGGTATGGAATTAGAGCCA
AGGTATAATTTACCGAGGTT -> GGTATAATTTACCGAGGTTA
GTGCGGCCCGGCACGTGCTT -> TGCGGCCCGGCACGTGCTTA
GATGAATCCCGTGGATTGCC -> ATGAATCCCGTGGATTGCCT
ATGGCATCTCCCCTAGTCTA -> TGGCATCTCCCCTAGTCTAT
GTGACCTTGAGTGGAGGTGG -> TGACCTTGAGTGGAGGTGGC
GCACTATTTTGGCCAGTTCA -> CACTATTTTGGCCAGTTCAA
ACGTGCTTATTTCGAATCAC -> CGTGCTTATTTCGAATCACG
AGGTTTTAAAGTTAGCGGAG -> GGTTTTAAAGTTAGCGGAGC
AATGGGTGACGTTGGCGAAC -> ATGGGTGACGTTGGCGAACA
ACTTTTCGCTCGGTACATGC -> CTTTTCGCTCGGTACATGCT
TTTGTCAAGGGACCAAAAAA -> TTGTCAAGGGACCAAAAAAA
ACGGTGCGAGGCGGACCCAA -> CGGTGCGAGGCGGACCCAAT
TTAGATTCGTTGCTCCTCTC -> TAGATTCGTTGCTCCTCTCG
AGTGAGATACCAGATTCCTT -> GTGAGATACCAGATTCCTTG
GCCCTCTCTAGAGTGAGATA -> CCCTCTCTAGAGTGAGATAC
TAAGCATCAATTTGCCCGTG -> AAGCATCAATTTGCCCGTGG
GGAACTAGAGTCGATAGGTA -> GAACTAGAGTCGATAGGTAC
ACCCGCTAGTAGCACAGACA -> CCCGCTAGTAGCACAGACAA
GGCTGGGCGTGCTTCAGCTA -> GCTGGGCGTGCTTCAGCTAC
AAGGGCACGAAAGGTTTTAA -> AGGGCACGAAAGGTTTTAAA
CAAGACAGTCTACGGGCCAT -> AAGACAGTCTACGGGCCATC
CTAGTCTATTCGTGTGCGGC -> TAGTCTATTCGTGTGCGGCC
CGGTACATGCTCTCTTGTTT -> GGTACATGCTCTCTTGTTTG
TGTGTATCAGAACTCGAGGG -> GTGTATCAGAACTCGAGGGG
AGATTCCTTGGCAGTTGTTG -> GATTCCTTGGCAGTTGTTGC
CTCTCTTGTTTGTCAAGGGA -> TCTCTTGTTTGTCAAGGGAC
CCCCACATCGACTCCGTGCC -> CCCACATCGACTCCGTGCCT
GGAACTCTCACTTGGTTCCA -> GAACTCTCACTTGGTTCCAC
ATGTGCAGGTCCAAGACAGT -> TGTGCAGGTCCAAGACAGTC
AAATCTTAATAGTCACTCCA -> AATCTTAATAGTCACTCCAT
AGTCTACGGGCCATCACCTC -> GTCTACGGGCCATCACCTCG
ATCTGGACCCTGATTCCCTG -> TCTGGACCCTGATTCCCTGG
TTCCCTGGTTGCTATGCGAC -> TCCCTGGTTGCTATGCGACT
GCCCTATAAGGTTTATGTTC -> CCCTATAAGGTTTATGTTCC
CAATGGGTGACGTTGGCGAA -> AATGGGTGACGTTGGCGAAC
CTTGCGCGTAGGGGTTTGTG -> TTGCGCGTAGGGGTTTGTGT
CCCTGATTCCCTGGTTGCTA -> CCTGATTCCCTGGTTGCTAT
CCTTGGCAGTTGTTGCGCTC -> CTTGGCAGTTGTTGCGCTCC
GTTCCACTATGCCAATAAGA -> TTCCACTATGCCAATAAGAA
GTTTGTGTATCAGAACTCGA -> TTTGTGTATCAGAACTCGAG
GTCTACGGGCCATCACCTCG -> TCTACGGGCCATCACCTCGC
GGACCCTGATTCCCTGGTTG -> GACCCTGATTCCCTGGTTGC
GGGGCTTAGATTCGTTGCTC -> GGGCTTAGATTCGTTGCTCC
GTTGCTATGCGACTAGAACA -> TTGCTATGCGACTAGAACAT
AGTGCCTATATTACGGAGGG -> GTGCCTATATTACGGAGGGC
TGATAGCAACTTGCGCGTAG -> GATAGCAACTTGCGCGTAGG
TTGCGCTCCTGGTTACTTAT -> TGCGCTCCTGGTTACTTATA
ATTTCGAATCACGACCTTCG -> TTTCGAATCACGACCTTCGT
GGCTTATTCCGACCTCCAGG -> GCTTATTCCGACCTCCAGGT
CGTATCATACATGCGCGCGA -> GTATCATACATGCGCGCGAC
CTGCGGAACTAGAGTCGATA -> TGCGGAACTAGAGTCGATAG
TGGTGGCACTATTTTGGCCA -> GGTGGCACTATTTTGGCCAG
GTCAAGGGACCAAAAAAAGG -> TCAAGGGACCAAAAAAAGGG
GGCTTAGATTCGTTGCTCCT -> GCTTAGATTCGTTGCTCCTC
CGCTCGGTACATGCTCTCTT -> GCTCGGTACATGCTCTCTTG
CGTAGGGGTTTGTGTATCAG -> GTAGGGGTTTGTGTATCAGA
TTATGTTCCCCACATCGACT -> TATGTTCCCCACATCGACTC
ATCCCCTGCACGGTGTTGTG -> TCCCCTGCACGGTGTTGTGT
GGGGTTTGTGTATCAGAACT -> GGGTTTGTGTATCAGAACTC
CCTCGCATAGGTATAATTTA -> CTCGCATAGGTATAATTTAC
TGACCTTGAGTGGAGGTGGC -> GACCTTGAGTGGAGGTGGCG
GTTAATCTGGACCCTGATTC -> TTAATCTGGACCCTGATTCC
CAGTCGGAGGACTTTTGAGT -> AGTCGGAGGACTTTTGAGTG
CTTGGTTCCACTATGCCAAT -> TTGGTTCCACTATGCCAATA
TTATACATCGTGCTCCCAAT -> TATACATCGTGCTCCCAATG
CTCTTGTTTGTCAAGGGACC -> TCTTGTTTGTCAAGGGACCA
GTGCTTCAGCTACAGAGAGT -> TGCTTCAGCTACAGAGAGTG
ACCTCGCATAGGTATAATTT -> CCTCGCATAGGTATAATTTA
TATTCCGACCTCCAGGTTGA -> ATTCCGACCTCCAGGTTGAC
GCGATAAGCATCAATTTGCC -> CGATAAGCATCAATTTGCCC
CTCTCTAGAGTGAGATACCA -> TCTCTAGAGTGAGATACCAG
AGTAGCACAGACAACAGTCG -> GTAGCACAGACAACAGTCGG
TGTTTGTCAAGGGACCAAAA -> GTTTGTCAAGGGACCAAAAA
TCGAGGGGGGCTTAGATTCG -> CGAGGGGGGCTTAGATTCGT
GGGCACGAAAGGTTTTAAAG -> GGCACGAAAGGTTTTAAAGT
TCTCACTTGGTTCCACTATG -> CTCACTTGGTTCCACTATGC
TATCAGAACTCGAGGGGGGC -> ATCAGAACTCGAGGGGGGCT
CTCCAGGTTGACCGTATCAT -> TCCAGGTTGACCGTATCATA
CTCCATCCGGCTCTGGGCAA -> TCCATCCGGCTCTGGGCAAG
AGTTCCAGACGGTGCGAGGC -> GTTCCAGACGGTGCGAGGCG
AATGGGCGATAAGCATCAAT -> ATGGGCGATAAGCATCAATT
GTGTATCAGAACTCGAGGGG -> TGTATCAGAACTCGAGGGGG
GATAGGTACTAATGATAGCA -> ATAGGTACTAATGATAGCAA
CGAGGGGGGCTTAGATTCGT -> GAGGGGGGCTTAGATTCGTT
AGTGGAGGTGGCGATGCGCA -> GTGGAGGTGGCGATGCGCAC
AATAAGAAACGCGAGTGCCT -> ATAAGAAACGCGAGTGCCTA
GAGGTGGCGATGCGCACTGC -> AGGTGGCGATGCGCACTGCG
AATTTGCCCGTGGCTTCCAG -> ATTTGCCCGTGGCTTCCAGT
CTTAATAGTCACTCCATCCG -> TTAATAGTCACTCCATCCGG
ACCGTTTTGATGAATCCCGT -> CCGTTTTGATGAATCCCGTG
AGGCGGACCCAATGTAGTTG -> GGCGGACCCAATGTAGTTGC
GCGGACTGCAGGAACTCTCA -> CGGACTGCAGGAACTCTCAC
GAGTTCCAGACGGTGCGAGG -> AGTTCCAGACGGTGCGAGGC
TTGGCTTATTCCGACCTCCA -> TGGCTTATTCCGACCTCCAG
CTACAGAGAGTGCTACAATG -> TACAGAGAGTGCTACAATGG
TTGAGTGACCTTGAGTGGAG -> TGAGTGACCTTGAGTGGAGG
GTAGCACAGACAACAGTCGG -> TAGCACAGACAACAGTCGGT
ACGACCTTCGTAGGAGTTCC -> CGACCTTCGTAGGAGTTCCA
TCGCATAGGTATAATTTACC -> CGCATAGGTATAATTTACCG
CGAAAGGTTTTAAAGTTAGC -> GAAAGGTTTTAAAGTTAGCG
GAACTAGAGTCGATAGGTAC -> AACTAGAGTCGATAGGTACT
TTCGAATCACGACCTTCGTA -> TCGAATCACGACCTTCGTAG
ATAGGTACTAATGATAGCAA -> TAGGTACTAATGATAGCAAC
CGCGACTGCCCTCTCTAGAG -> GCGACTGCCCTCTCTAGAGT
TTGCGCGAAAGAACCGTTTT -> TGCGCGAAAGAACCGTTTTG
CCTGGTTGCTATGCGACTAG -> CTGGTTGCTATGCGACTAGA
GGCGATAAGCATCAATTTGC -> GCGATAAGCATCAATTTGCC
TTACTTATACATCGTGCTCC -> TACTTATACATCGTGCTCCC
CGATAGGTACTAATGATAGC -> GATAGGTACTAATGATAGCA
CCCAATGGGCGATAAGCATC -> CCAATGGGCGATAAGCATCA
TGTTCCCCACATCGACTCCG -> GTTCCCCACATCGACTCCGT
GCGACTGCCCTCTCTAGAGT -> CGACTGCCCTCTCTAGAGTG
TCCCCTGCACGGTGTTGTGT -> CCCCTGCACGGTGTTGTGTG
CATTGGCTTATTCCGACCTC -> ATTGGCTTATTCCGACCTCC
GAGAGTGCTACAATGGCCCT -> AGAGTGCTACAATGGCCCTA
TGCTCCCAATGGGCGATAAG -> GCTCCCAATGGGCGATAAGC
GGTGCGAGGCGGACCCAATG -> GTGCGAGGCGGACCCAATGT
ACGGTGTTGTGTGGCTGGGC -> CGGTGTTGTGTGGCTGGGCG
CAGACAACAGTCGGTTCTTG -> AGACAACAGTCGGTTCTTGC
TGGAGGTGGCGATGCGCACT -> GGAGGTGGCGATGCGCACTG
CAAATCTTAATAGTCACTCC -> AAATCTTAATAGTCACTCCA
CTAGTAGCACAGACAACAGT -> TAGTAGCACAGACAACAGTC
CAGAACTCGAGGGGGGCTTA -> AGAACTCGAGGGGGGCTTAG
GACCAAAAAAAGGGCACGAA -> ACCAAAAAAAGGGCACGAAA
GTGTATGGTATGGAATTAGA -> TGTATGGTATGGAATTAGAG
TAGGTATAATTTACCGAGGT -> AGGTATAATTTACCGAGGTT
CCCTGCACGGTGTTGTGTGG -> CCTGCACGGTGTTGTGTGGC
AGAACCGTTTTGATGAATCC -> GAACCGTTTTGATGAATCCC
AGGACTTTTGAGTGACCTTG -> GGACTTTTGAGTGACCTTGA
TCGGTTCTTGCGCGAAAGAA -> CGGTTCTTGCGCGAAAGAAC
GTTCCCCACATCGACTCCGT -> TTCCCCACATCGACTCCGTG
ACTATTTTGGCCAGTTCAAA -> CTATTTTGGCCAGTTCAAAT
CCAATGGGTGACGTTGGCGA -> CAATGGGTGACGTTGGCGAA
CAAGAATCCCTGATATGTGC -> AAGAATCCCTGATATGTGCA
AGCGGAGCTCCTTCACCCGC -> GCGGAGCTCCTTCACCCGCT
CCGTATCATACATGCGCGCG -> CGTATCATACATGCGCGCGA
CAGAGAGTGCTACAATGGCC -> AGAGAGTGCTACAATGGCCC
TCAATGTGTTGGTGGCACTA -> CAATGTGTTGGTGGCACTAT
AACTCGAGGGGGGCTTAGAT -> ACTCGAGGGGGGCTTAGATT
ACTGCAGGAACTCTCACTTG -> CTGCAGGAACTCTCACTTGG
AGTTAGCGGAGCTCCTTCAC -> GTTAGCGGAGCTCCTTCACC
TTGTTGCGCTCCTGGTTACT -> TGTTGCGCTCCTGGTTACTT
CACATCGACTCCGTGCCTGT -> ACATCGACTCCGTGCCTGTA
TCACTCCATCCGGCTCTGGG -> CACTCCATCCGGCTCTGGGC
AAAAAGGGCACGAAAGGTTT -> AAAAGGGCACGAAAGGTTTT
TTTGATGAATCCCGTGGATT -> TTGATGAATCCCGTGGATTG
ATAAGAAACGCGAGTGCCTA -> TAAGAAACGCGAGTGCCTAT
GGCTCTGGGCAAGAATCCCT -> GCTCTGGGCAAGAATCCCTG
GACCCAATGTAGTTGCAGCT -> ACCCAATGTAGTTGCAGCTA
ACAGTCGGTTCTTGCGCGAA -> CAGTCGGTTCTTGCGCGAAA
TTGATGAATCCCGTGGATTG -> TGATGAATCCCGTGGATTGC
TTAGCGGAGCTCCTTCACCC -> TAGCGGAGCTCCTTCACCCG
CTCCGTGCCTGTATCCAGAG -> TCCGTGCCTGTATCCAGAGT
AGGTTTATGTTCCCCACATC -> GGTTTATGTTCCCCACATCG
GCCCGTGGCTTCCAGTCGGA -> CCCGTGGCTTCCAGTCGGAG
TTCGTAGGAGTTCCAGACGG -> TCGTAGGAGTTCCAGACGGT
CATCTCCCCTAGTCTATTCG -> ATCTCCCCTAGTCTATTCGT
TGTATCAGAACTCGAGGGGG -> GTATCAGAACTCGAGGGGGG
GTGCGAGGCGGACCCAATGT -> TGCGAGGCGGACCCAATGTA