GCTCGCTCCCA -> CTCGCTCCCAA
TTCTGGCCTTT -> TCTGGCCTTTG
GTTTCCTACTA -> TTTCCTACTAA
GGCCATCCAAT -> GCCATCCAATT
AATTTTTGAGT -> ATTTTTGAGTG
TAGAGAAACGG -> AGAGAAACGGA
CGTGACGCGGT -> GTGACGCGGTC
ACGAAATACAC -> CGAAATACACT
TCTCCATTTAG -> CTCCATTTAGG
GGGACCGTATG -> GGACCGTATGC
AGGGGACGGTT -> GGGGACGGTTT
GATCATCACAT -> ATCATCACATG
AAAAACTCATT -> AAAACTCATTA
ACTGTTTCCTA -> CTGTTTCCTAC
AGAAACATGTT -> GAAACATGTTC
TGGGTACTCTT -> GGGTACTCTTT
TGGATATTCCT -> GGATATTCCTA
AGAAAGCATAT -> GAAAGCATATA
CCCCGGTGTAA -> CCCGGTGTAAA
GTACCCATCAC -> TACCCATCACG
GAATTCATAAT -> AATTCATAATA
ACATATGGATA -> CATATGGATAT
CACTGTTGCCG -> ACTGTTGCCGA
ATCGAAGTCAG -> TCGAAGTCAGA
AGGCTAGGAAC -> GGCTAGGAACG
ATGAGTAGAGA -> TGAGTAGAGAA
TCGGGTTCGAC -> CGGGTTCGACA
GCAATTCTCCA -> CAATTCTCCAT
GATTAGTCCTT -> ATTAGTCCTTG
ATGTTCGGGTT -> TGTTCGGGTTC
CCCTCCACCGG -> CCTCCACCGGG
GAATACAGGAT -> AATACAGGATG
ATGGCAGACTT -> TGGCAGACTTC
TATCGTCCATT -> ATCGTCCATTC
CTATATGTTCT -> TATATGTTCTG
AATTCCAATAA -> ATTCCAATAAG
ATTCTAAAGCA -> TTCTAAAGCAG
CGCATCATAGA -> GCATCATAGAG
ATTCTGGCCTT -> TTCTGGCCTTT
AAGTTGGCATA -> AGTTGGCATAA
TAACAGAACCT -> AACAGAACCTG
TACAGGATGAG -> ACAGGATGAGT
CTAAAGCAGAC -> TAAAGCAGACT
GATGTCACGTG -> ATGTCACGTGA
GAAGCATAAGG -> AAGCATAAGGT
TTTCGGACAAT -> TTCGGACAATG
TAGCATTACTA -> AGCATTACTAC
CCACGCCGCTC -> CACGCCGCTCG
CAAAGGCCATC -> AAAGGCCATCC
CCTCCACCGGG -> CTCCACCGGGC
AATTATGCGAC -> ATTATGCGACC
GATCCCATATA -> ATCCCATATAC
CCACAAGACAC -> CACAAGACACC
AAAACGTAGGT -> AAACGTAGGTA
TATATTTCTCC -> ATATTTCTCCT
CAATCTACTAG -> AATCTACTAGC
AGTCTACAATG -> GTCTACAATGA
TAGATCAGGGA -> AGATCAGGGAT
GCCTAAGAGAC -> CCTAAGAGACT
GTGACTATATG -> TGACTATATGT
TCCTTGATCCC -> CCTTGATCCCA
AAGATGTGTCC -> AGATGTGTCCC
GACCGAAGGGA -> ACCGAAGGGAG
CCAGCAACATA -> CAGCAACATAT
CTAGCTACCAG -> TAGCTACCAGG
CACAAGACGGC -> ACAAGACGGCA
TTAAGCGGAGT -> TAAGCGGAGTC
AGACTTCAGGA -> GACTTCAGGAC
ATCACATGTCT -> TCACATGTCTC
GCATGCCTCAG -> CATGCCTCAGC
AAACGGAATCA -> AACGGAATCAT
CCTGAGGCCTC -> CTGAGGCCTCC
TGCTTCGAACT -> GCTTCGAACTT
CTAAATCCTGT -> TAAATCCTGTT
ATGCAAGGCTC -> TGCAAGGCTCT
TACGTGTCCCA -> ACGTGTCCCAG
TTATGCCATGG -> TATGCCATGGG
TATCTGAATCG -> ATCTGAATCGC
GCACCGCTTCT -> CACCGCTTCTC
GCTTCTCTGGT -> CTTCTCTGGTG
GGGGCGTCGTG -> GGGCGTCGTGA
GCGCGTTACCC -> CGCGTTACCCT
CCGCTTCTCTG -> CGCTTCTCTGG
CCGTATGCAAG -> CGTATGCAAGG
GCACCGTGTTG -> CACCGTGTTGC
ATCACACTACG -> TCACACTACGT
GGTGTAAATGC -> GTGTAAATGCT
AACGCACTGTT -> ACGCACTGTTG
AGCACTGTCCG -> GCACTGTCCGG
GCTCACACTGT -> CTCACACTGTG
ATTTCTCCTGG -> TTTCTCCTGGA
CCATTTAGGGG -> CATTTAGGGGC
TGCAGCCGTGC -> GCAGCCGTGCC
GAAGGCAATAC -> AAGGCAATACG
ATCTGCTACTC -> TCTGCTACTCG
AAGGTGAAGGC -> AGGTGAAGGCA
CTAAGCACTGT -> TAAGCACTGTC
TCTCGGTTGCA -> CTCGGTTGCAG
TCGAACTTATG -> CGAACTTATGC
AGCAACATATG -> GCAACATATGG
CAGTATCGTCC -> AGTATCGTCCT
GGACGAAAAAC -> GACGAAAAACT
ACGGTGTGTCG -> CGGTGTGTCGT
CCTTTACCTTT -> CTTTACCTTTG
CGGGTGGCCTC -> GGGTGGCCTCC
AGATGTGTCCC -> GATGTGTCCCA
CGTTTAAGCGG -> GTTTAAGCGGA
CAGACTTCGGA -> AGACTTCGGAA
TATGTTCTGGA -> ATGTTCTGGAT
TAGCGTTTAAG -> AGCGTTTAAGC
TGTATTGATTG -> GTATTGATTGG
GTTTCGGACAA -> TTTCGGACAAT
TGTAGATCCAT -> GTAGATCCATA
ATTCGTGGGTG -> TTCGTGGGTGG
CCTAAGAACAG -> CTAAGAACAGA
AACCTGCAGAA -> ACCTGCAGAAA
AATCCTGTGTT -> ATCCTGTGTTA
TCTCCCACAAG -> CTCCCACAAGA
GGGATCAGCCT -> GGATCAGCCTG
TCGAGGGACGA -> CGAGGGACGAG
GGCCGACGCTG -> GCCGACGCTGC
CTGCCTGAACG -> TGCCTGAACGG
AGGGGCGTCGT -> GGGGCGTCGTG
TAGCTACCAGG -> AGCTACCAGGG
AAGGCAATACG -> AGGCAATACGT
GGACGACTTGT -> GACGACTTGTA
CGGAGTCCAAA -> GGAGTCCAAAG
TGAATTATGCG -> GAATTATGCGA
ATCATAAACGA -> TCATAAACGAG
ACCTTGCCTAA -> CCTTGCCTAAG
ATATTTCTCCT -> TATTTCTCCTG
CTTCGCCCTTT -> TTCGCCCTTTC
CCTAGTACCCA -> CTAGTACCCAT
CAGGGATGTAT -> AGGGATGTATT
TTCAAACCACG -> TCAAACCACGT
ATCCCTAAAGA -> TCCCTAAAGAT
CAGTAAGTGGA -> AGTAAGTGGAT
ATGACGAAATA -> TGACGAAATAC
GAGGGCGAGGC -> AGGGCGAGGCA
TATTTCTCCTG -> ATTTCTCCTGG
GGGAATGGCCC -> GGAATGGCCCC
TTGTAGTCATC -> TGTAGTCATCC
GAACGTTCTAA -> AACGTTCTAAG
TTATTGAGTCT -> TATTGAGTCTT
AGGGCGAGGCA -> GGGCGAGGCAC
GTCCTTGATCC -> TCCTTGATCCC
CTGAACGGAAC -> TGAACGGAACG
ATATTCTAAAG -> TATTCTAAAGC
TCCAATAAGCG -> CCAATAAGCGG
CAGTGAACTGG -> AGTGAACTGGA
GAGGCCACGAG -> AGGCCACGAGA
AAATGCTGGGA -> AATGCTGGGAC
CTACTAGCGAT -> TACTAGCGATA
ACACATATGAT -> CACATATGATC
CTGCTACTCGC -> TGCTACTCGCA
TAGTCCTTGAT -> AGTCCTTGATC
GCGGGAGAGAA -> CGGGAGAGAAA
CGCAGATCCCT -> GCAGATCCCTA
CGAACTTATGC -> GAACTTATGCC
GAATCCATTGT -> AATCCATTGTA
CTCTCGCTCGG -> TCTCGCTCGGG
CCTCCCGTCTA -> CTCCCGTCTAT
GTCCCAGTGCT -> TCCCAGTGCTC
GGGTTTCAGAA -> GGTTTCAGAAT
GGATCAGCCTG -> GATCAGCCTGA
ATCCAATTCTG -> TCCAATTCTGG
CCTTTGAGTAG -> CTTTGAGTAGA
GGAGTCCAAAG -> GAGTCCAAAGG
CTTGTCGGTCT -> TTGTCGGTCTT
CGTCAACATTC -> GTCAACATTCT
GATCGAGGGAC -> ATCGAGGGACG
ATGTGGCGAGT -> TGTGGCGAGTA
CTCCCGTCTAT -> TCCCGTCTATC
GCACGGCCATT -> CACGGCCATTG
ACTGTGAAGCG -> CTGTGAAGCGA
AGAGGCTAGGA -> GAGGCTAGGAA
CTTGCTTCGAA -> TTGCTTCGAAC
AGCCTGAGGAA -> GCCTGAGGAAG
ATAGGCCTGGT -> TAGGCCTGGTA
TAATCCTGTGT -> AATCCTGTGTT
CGTAGGTAGAT -> GTAGGTAGATC
TCACGTGACGC -> CACGTGACGCG
GTCTATCGTCC -> TCTATCGTCCA
TGAGTGATGTC -> GAGTGATGTCA
ACCGCACGGCC -> CCGCACGGCCA
TATGGATATTC -> ATGGATATTCC
AGGACCTCGCC -> GGACCTCGCCG
TCACGACCAGT -> CACGACCAGTG
CATATATTTCT -> ATATATTTCTC
CAGAAGCATAA -> AGAAGCATAAG
TACCTTCTTGC -> ACCTTCTTGCC
TTATGCGAGAG -> TATGCGAGAGT
TCCCATATACG -> CCCATATACGT
GTTGAAGCCGA -> TTGAAGCCGAT
TCCCATCGAAC -> CCCATCGAACT
TAGCGCTCCCG -> AGCGCTCCCGG
GTGCCGTACGA -> TGCCGTACGAT
ATAATAGAAAC -> TAATAGAAACA
TGCTGGGACCG -> GCTGGGACCGT
CGAAGTCAGAA -> GAAGTCAGAAG
AGCTTGCTTCG -> GCTTGCTTCGA
GACGAAAAACT -> ACGAAAAACTC
TTGAAGCCGAT -> TGAAGCCGATC
TGCCTAAGAGA -> GCCTAAGAGAC
TCCCAGAGACC -> CCCAGAGACCC
GTCCATTCCCC -> TCCATTCCCCG
ACCGAAGGGAG -> CCGAAGGGAGG
AGTCATCCTAG -> GTCATCCTAGC
GGTCCTTCCTG -> GTCCTTCCTGA
CTTCGAACTTA -> TTCGAACTTAT
ACAATGAATTA -> CAATGAATTAT
GAATGATGTTG -> AATGATGTTGA
ATGTTGAAATG -> TGTTGAAATGT
GTCTCCCACAA -> TCTCCCACAAG
CATTGCGACTG -> ATTGCGACTGT
GGGTGGGACGA -> GGTGGGACGAA
GTCCAAAGGCC -> TCCAAAGGCCA
TTCCTACTAAT -> TCCTACTAATA
TTGGAGGTCTC -> TGGAGGTCTCA
CTAAGAGACTT -> TAAGAGACTTC
GGCTAGGAACG -> GCTAGGAACGC
CACATATGATC -> ACATATGATCC
CAACCGACTCT -> AACCGACTCTT
ACGCACTGTTG -> CGCACTGTTGC
CAGATCCCTAA -> AGATCCCTAAA
ATGTCACGTGA -> TGTCACGTGAC
CCTTCTTGCCA -> CTTCTTGCCAG
ACTCTTTCCCA -> CTCTTTCCCAC
GTTTCTTGGAG -> TTTCTTGGAGG
TTACCCTTCGC -> TACCCTTCGCC
ACTATGGAGCA -> CTATGGAGCAC
GGGCGAGGCAC -> GGCGAGGCACC
CTGAATCGCCG -> TGAATCGCCGG
CCACGTCTGCA -> CACGTCTGCAG
GCCGACTTCTC -> CCGACTTCTCT
TACACTTAGGG -> ACACTTAGGGT
AAGATACCTTT -> AGATACCTTTA
TAGGCCTGGTA -> AGGCCTGGTAG
GAAGTAACAGA -> AAGTAACAGAA
TAATTCTCAGA -> AATTCTCAGAA
ATATGGATATT -> TATGGATATTC
CATCGAACTTA -> ATCGAACTTAG
GCGGAGTCCAA -> CGGAGTCCAAA
TAGGGGCGTCG -> AGGGGCGTCGT
AGACACCGCAC -> GACACCGCACG
TCAGGGATGTA -> CAGGGATGTAT
CAAACGTCAAC -> AAACGTCAACA
ACTGAGGGACA -> CTGAGGGACAG
ACTACTATGGA -> CTACTATGGAG
TCGGTTGGTCC -> CGGTTGGTCCC
ACACTACGTGT -> CACTACGTGTC
TACGGCAGCTA -> ACGGCAGCTAA
ATGAATTATGC -> TGAATTATGCG
AGGGTAGAAAG -> GGGTAGAAAGC
GGCCTCTGACG -> GCCTCTGACGC
TTCGAACAAAT -> TCGAACAAATC
ACAAGACACCG -> CAAGACACCGC
AGTACCCATCA -> GTACCCATCAC
TCTTTCCCACG -> CTTTCCCACGC
AAAGAGGCTAG -> AAGAGGCTAGG
CCCAATCTACT -> CCAATCTACTA
CTCTTATTGAG -> TCTTATTGAGT
CATGGGCCGCA -> ATGGGCCGCAT
TACCCTTCGCC -> ACCCTTCGCCC
TTTGAGTGATG -> TTGAGTGATGT
AAGAGACTTCA -> AGAGACTTCAG
TACAACCGACT -> ACAACCGACTC
ATTTTTGAGTG -> TTTTTGAGTGA
TGACTCTCACC -> GACTCTCACCA
TTCATAATAGA -> TCATAATAGAA
GAGTAGAGAAA -> AGTAGAGAAAC
GGAGGTCTCAC -> GAGGTCTCACG
CATAAGGTGAA -> ATAAGGTGAAG
TCGTGACTATA -> CGTGACTATAT
TACAATTATAT -> ACAATTATATT
TTGCCAGCAAC -> TGCCAGCAACA
GCTAATCCTGT -> CTAATCCTGTG
GCAAGGCTCTC -> CAAGGCTCTCG
GGACCGTATGC -> GACCGTATGCA
CACGCCGCTCG -> ACGCCGCTCGC
GGCGAGTATTC -> GCGAGTATTCG
CGTGTTGCATG -> GTGTTGCATGC
GCAAGTTGAAG -> CAAGTTGAAGC
TACTACTATGG -> ACTACTATGGA
CCGCACCGTGT -> CGCACCGTGTT
GAAACGGAATC -> AAACGGAATCA
TGAGAATGATG -> GAGAATGATGT
AAACATGTTCG -> AACATGTTCGG
TATCGTCCTGT -> ATCGTCCTGTC
GAACTTATGCC -> AACTTATGCCA
GTGTCGTCGCT -> TGTCGTCGCTT
CCGGGCGAGTA -> CGGGCGAGTAC
TCTGACGCGAC -> CTGACGCGACT
CTAGCGGAGTC -> TAGCGGAGTCG
CATCCTAGCTA -> ATCCTAGCTAC
TAAGAACAGAT -> AAGAACAGATT
TTGTCGGTCTT -> TGTCGGTCTTC
CGAAAAACTCA -> GAAAAACTCAT
TTGACTCTCAC -> TGACTCTCACC
GACAGAGCTTG -> ACAGAGCTTGC
GAGGGACAGGT -> AGGGACAGGTA
GGCCTCCCGTC -> GCCTCCCGTCT
AACAGAACCTG -> ACAGAACCTGC
AACGTTCTAAG -> ACGTTCTAAGA
GTACCTAAGCA -> TACCTAAGCAC
ATTAGGGGTCC -> TTAGGGGTCCT
AAACGAGCGCG -> AACGAGCGCGT
GCGATAGTGCT -> CGATAGTGCTA
ATATGATCCAG -> TATGATCCAGC
AGCATATATTT -> GCATATATTTC
TATATATATTC -> ATATATATTCT
TGGGCCGCATC -> GGGCCGCATCA
AGTAAGTGGAT -> GTAAGTGGATC
ACGTCAACATT -> CGTCAACATTC
CCCTAAAGATT -> CCTAAAGATTA
GGCCTTTGAAG -> GCCTTTGAAGT
GGCAATACGTG -> GCAATACGTGA
GCCTCCCGTCT -> CCTCCCGTCTA
TCGCCCTTTCG -> CGCCCTTTCGA
GAGGCTAGGAA -> AGGCTAGGAAC
TCCAATTCTGG -> CCAATTCTGGC
GCCCTTTCGAG -> CCCTTTCGAGC
TATTCGGGTCT -> ATTCGGGTCTA
GGCGAGGCACC -> GCGAGGCACCA
AGCCCTCCACC -> GCCCTCCACCG
TATTCCTATAT -> ATTCCTATATA
CACATGTCTCC -> ACATGTCTCCC
GTAATGCGGTG -> TAATGCGGTGC
CTCGGTTGCAG -> TCGGTTGCAGC
GGAGAGAAAGA -> GAGAGAAAGAG
TACGTATCCGT -> ACGTATCCGTT
AAGTAACAGAA -> AGTAACAGAAC
AAGGTCTGGCG -> AGGTCTGGCGT
CTTTACCTTTG -> TTTACCTTTGA
TTACCTTGCCT -> TACCTTGCCTA
TCTAAGATACC -> CTAAGATACCT
ATTTGCCACCC -> TTTGCCACCCT
TAAGATGTGTC -> AAGATGTGTCC
ACTAGCGATAG -> CTAGCGATAGT
GTTGCATGCCT -> TTGCATGCCTC
CCTGTTTCGGT -> CTGTTTCGGTT
AAAGCAGACTA -> AAGCAGACTAC
GGTTAGCAGCA -> GTTAGCAGCAT
GAGACCCTAGC -> AGACCCTAGCG
TGGTGCCTAAG -> GGTGCCTAAGA
TTCTTGGAGGT -> TCTTGGAGGTC
GCGTTACCCTT -> CGTTACCCTTC
GGAATCATAAA -> GAATCATAAAC
ATGCGGTGCAT -> TGCGGTGCATA
CAGGGGAGGTT -> AGGGGAGGTTA
TGTAAATGCTG -> GTAAATGCTGG
ACTCTTATTGA -> CTCTTATTGAG
ACGGCCGACGC -> CGGCCGACGCT
CACACTACGTG -> ACACTACGTGT
ACGCGGTCCGG -> CGCGGTCCGGT
GGAGGCCACGA -> GAGGCCACGAG
TTACGGCAGCT -> TACGGCAGCTA
ATGTCTCCCAC -> TGTCTCCCACA
GACTTGTACCT -> ACTTGTACCTA
ATTATATTTGC -> TTATATTTGCC
CAGAATCCGAA -> AGAATCCGAAG
AAGCGATACCC -> AGCGATACCCC
CTTTGGTGCCT -> TTTGGTGCCTA
GGACAATGGCA -> GACAATGGCAG
TTTCCTACTAA -> TTCCTACTAAT
CCAATTCTGGC -> CAATTCTGGCC
CTGGGATCAGC -> TGGGATCAGCC
CGTTAATTCTC -> GTTAATTCTCA
GGTTACCTTGC -> GTTACCTTGCC
CCCGGTGTAAA -> CCGGTGTAAAT
GAAATACACTT -> AAATACACTTA
TTTACGGCAGC -> TTACGGCAGCT
ATGATGTTGAA -> TGATGTTGAAA
ACGTGACGCGG -> CGTGACGCGGT
GCCACGTTATG -> CCACGTTATGA
GGATGTATTGA -> GATGTATTGAT
CTCGAAATCAG -> TCGAAATCAGT
CTCCCAATTCG -> TCCCAATTCGG
GTACGATAGCT -> TACGATAGCTG
CTAGCGATAGT -> TAGCGATAGTG
AGGGAGGCCAC -> GGGAGGCCACG
CGGCACTGCGG -> GGCACTGCGGT
GAACTGGAGGC -> AACTGGAGGCA
ATATGTTCTGG -> TATGTTCTGGA
GCGTTTAAGCG -> CGTTTAAGCGG
GAAGTCAGAAG -> AAGTCAGAAGC
AACCACGTCTG -> ACCACGTCTGC
TCGCATCACTG -> CGCATCACTGG
AACCTATGATA -> ACCTATGATAG
ACTCATTAGGG -> CTCATTAGGGG
AAGCCGATCAT -> AGCCGATCATC
GTAGGTAGATC -> TAGGTAGATCA
TCAGAATCACA -> CAGAATCACAC
CGACTGTTTCC -> GACTGTTTCCT
TTAACACATAT -> TAACACATATG
TATGCAAGGCT -> ATGCAAGGCTC
AATAGCGTTTA -> ATAGCGTTTAA
AGGCACCAGTA -> GGCACCAGTAA
GTGCCTAAGAA -> TGCCTAAGAAC
AAGGGGACGGT -> AGGGGACGGTT
AATGGCAGACT -> ATGGCAGACTT
ATGATAGCATT -> TGATAGCATTA
GCCGCATCATA -> CCGCATCATAG
CTATGATAGCA -> TATGATAGCAT
CGCCGCGCAGA -> GCCGCGCAGAT
AGCTACCAGGG -> GCTACCAGGGG
GTATTAACACA -> TATTAACACAT
TTATGCGGCGG -> TATGCGGCGGG
AGCGATAGTGC -> GCGATAGTGCT
TACCTAAGCAC -> ACCTAAGCACT
TTCTGCAGGGA -> TCTGCAGGGAA
AGAGACCCTAG -> GAGACCCTAGC
TGATCCCATAT -> GATCCCATATA
GACGCGGTCCG -> ACGCGGTCCGG
CGAATTCATAA -> GAATTCATAAT
GCATCATAGAG -> CATCATAGAGT
GCGGCAATTCT -> CGGCAATTCTC
CTAAGAACAGA -> TAAGAACAGAT
CATTACTACTA -> ATTACTACTAT
CGGTCTTCGAA -> GGTCTTCGAAC
ATTTTACGGCA -> TTTTACGGCAG
GCCCTCCACCG -> CCCTCCACCGG
CAATTATATTT -> AATTATATTTG
GGTCGTAATGC -> GTCGTAATGCG
GCACTGCGGTT -> CACTGCGGTTA
GTAGATCAGGG -> TAGATCAGGGA
CCATTCCCCGA -> CATTCCCCGAA
CTGGAGGCAAG -> TGGAGGCAAGT
ACGAGATGTTT -> CGAGATGTTTC
GGATAGCTCAC -> GATAGCTCACA
TCTAAAGCAGA -> CTAAAGCAGAC
ACCGTGTTGCA -> CCGTGTTGCAT
GCAGACTTCGG -> CAGACTTCGGA
GAAATGTGGCG -> AAATGTGGCGA
AGTGAACTGGA -> GTGAACTGGAG
TGACGCGGTCC -> GACGCGGTCCG
ACCTTTGAGTA -> CCTTTGAGTAG
CCCATCACGGT -> CCATCACGGTG
GCGACTGTTTC -> CGACTGTTTCC
CAGATTCGTGG -> AGATTCGTGGG
TCTATCGTCCA -> CTATCGTCCAT
ATACCTTTACC -> TACCTTTACCT
TCCCGTCTATC -> CCCGTCTATCG
CTATATATATT -> TATATATATTC
AGGACGACTTG -> GGACGACTTGT
ACGCGACTGCC -> CGCGACTGCCT
ATCAGCCTGAG -> TCAGCCTGAGG
CATCCAATTCT -> ATCCAATTCTG
CGTAATGCGGT -> GTAATGCGGTG
TTTCTGCAGGG -> TTCTGCAGGGA
ATACGTATCCG -> TACGTATCCGT
CAATGAATTAT -> AATGAATTATG
CGTATGCAAGG -> GTATGCAAGGC
CCTGGTAGAAC -> CTGGTAGAACC
GACTCTTATTG -> ACTCTTATTGA
AGGCAAGTTGA -> GGCAAGTTGAA
ATGCTGGGACC -> TGCTGGGACCG
TGCTCGAAAGG -> GCTCGAAAGGT
CATGTTCGGGT -> ATGTTCGGGTT
CGCTCGCTCCC -> GCTCGCTCCCA
GCGGTGCATAG -> CGGTGCATAGG
GACGGCACTGC -> ACGGCACTGCG
ACTTATGCCAT -> CTTATGCCATG
ACCTTCTTGCC -> CCTTCTTGCCA
ACTTAGGGTTT -> CTTAGGGTTTC
TTAGGGGCGTC -> TAGGGGCGTCG
ACGAAAGGACG -> CGAAAGGACGA
CTGCAGAAAAG -> TGCAGAAAAGG
CACGACCAGTG -> ACGACCAGTGA
CAGTACAACCG -> AGTACAACCGA
CTTGATCCCAT -> TTGATCCCATA
AGAACCTATGA -> GAACCTATGAT
GCCGACGCTGC -> CCGACGCTGCC
TGGTGCGAAGT -> GGTGCGAAGTA
AGAGACTTCAG -> GAGACTTCAGG
AGGTAGTTCCC -> GGTAGTTCCCA
GCGAAGTAATT -> CGAAGTAATTT
GAGTCTTGTCG -> AGTCTTGTCGG
CCCATATACGT -> CCATATACGTA
CCGGAGTGCCG -> CGGAGTGCCGC
CCCTTTTCCCC -> CCTTTTCCCCC
TAAGTGGATCC -> AAGTGGATCCT
GCTTCTCGGTT -> CTTCTCGGTTG
CCTTCCTGAGG -> CTTCCTGAGGC
GGTATTAACAC -> GTATTAACACA
ATTACTACTAT -> TTACTACTATG
TGCAGAAAAGG -> GCAGAAAAGGG
CCGATCATCAC -> CGATCATCACA
CGGTTGGTCCC -> GGTTGGTCCCA
ATCCTGTGTTA -> TCCTGTGTTAT
TGGATCCTAAA -> GGATCCTAAAT
AGTACAACCGA -> GTACAACCGAC
TATTTGCCACC -> ATTTGCCACCC
TCGAAATCAGT -> CGAAATCAGTA
TCGCTCCCAAT -> CGCTCCCAATT
TACGTGATTCC -> ACGTGATTCCC
ATTCTCCATTT -> TTCTCCATTTA
CTCGCTCGGGA -> TCGCTCGGGAG
CGGCCGACGCT -> GGCCGACGCTG
TCCCAATTCGG -> CCCAATTCGGA
TCGAACAAATC -> CGAACAAATCT
GACGCGACTGC -> ACGCGACTGCC
GTGAAGCGATA -> TGAAGCGATAC
CTAAGATACCT -> TAAGATACCTT
TCATAGAGTTT -> CATAGAGTTTA
TGGGACGAAAA -> GGGACGAAAAA
AGCAAGTCTAC -> GCAAGTCTACA
ACAGGATGAGT -> CAGGATGAGTA
TTGAAATGTGG -> TGAAATGTGGC
CGGTCCGGTCC -> GGTCCGGTCCC
GATGAGTAGAG -> ATGAGTAGAGA
AAGCACTGTCC -> AGCACTGTCCG
CGGACAGGATC -> GGACAGGATCG
TCTGGCGTCTG -> CTGGCGTCTGG
GGTTGCAGCCG -> GTTGCAGCCGT
ACCGGGCGAGT -> CCGGGCGAGTA
ATCATAGAGTT -> TCATAGAGTTT
TCGGAACCGGT -> CGGAACCGGTT
CTTGTACCTAA -> TTGTACCTAAG
GGTTTCAGAAT -> GTTTCAGAATC
CGTCTGGGATC -> GTCTGGGATCA
TCCGGGTGGCC -> CCGGGTGGCCT
ATGCGAGAGTG -> TGCGAGAGTGC
GGCCATTGCGA -> GCCATTGCGAC
TAGGGTTTCAG -> AGGGTTTCAGA
ATAGCTGAATA -> TAGCTGAATAC
GGCGTCGTGAC -> GCGTCGTGACT
TGAGTAGAGAA -> GAGTAGAGAAA
GAAAGCATATA -> AAAGCATATAT
GACCGTATGCA -> ACCGTATGCAA
TTCGACAGAGC -> TCGACAGAGCT
CCCTTCGCCCT -> CCTTCGCCCTT
TGTTGCCGACT -> GTTGCCGACTT
AGAAGCATAAG -> GAAGCATAAGG
CCATCGAACTT -> CATCGAACTTA
TACCTTGCCTA -> ACCTTGCCTAA
AGCAGCATACA -> GCAGCATACAA
TGTAGTCATCC -> GTAGTCATCCT
TACCCCATGAG -> ACCCCATGAGT
CGAAATCAGTA -> GAAATCAGTAA
GGATATTCCTA -> GATATTCCTAT
CAGACTACAAA -> AGACTACAAAC
GCTAGATCGAA -> CTAGATCGAAG
ATAGAGTTTAT -> TAGAGTTTATG
GGCAGACTTCG -> GCAGACTTCGG
TTCTAAGATAC -> TCTAAGATACC
AGCATAAGGTG -> GCATAAGGTGA
TGCCATGGGCC -> GCCATGGGCCG
TGCATAGGGCC -> GCATAGGGCCT
CGAAGTAATTT -> GAAGTAATTTT
GATACCTTTAC -> ATACCTTTACC
TAAACGAGCGC -> AAACGAGCGCG
GCCGTGCCGTA -> CCGTGCCGTAC
GACAGGATCGA -> ACAGGATCGAG
GGGTTATGCGG -> GGTTATGCGGC
TCCATTCCCCG -> CCATTCCCCGA
TGCCTGTAGAT -> GCCTGTAGATC
GATCAGCCTGA -> ATCAGCCTGAG
TCCTTCCTGAG -> CCTTCCTGAGG
CTGTCGAGGGC -> TGTCGAGGGCG
CCTATATATAT -> CTATATATATT
TATGGAGCACC -> ATGGAGCACCG
CCGGTCCCCGA -> CGGTCCCCGAT
GCAGAAAAGGG -> CAGAAAAGGGG
TTACCTTTGAG -> TACCTTTGAGT
TGCAAGGCTCT -> GCAAGGCTCTC
GGAAGCCCGGA -> GAAGCCCGGAG
GTCCTGTCGAG -> TCCTGTCGAGG
TCGAACTTAGT -> CGAACTTAGTA
TAGGAACGCAC -> AGGAACGCACT
ATATATTTCTC -> TATATTTCTCC
AATCCGAAGAA -> ATCCGAAGAAG
TTGGCATAATT -> TGGCATAATTC
TAGTACCCATC -> AGTACCCATCA
AGCAGACTACA -> GCAGACTACAA
GGTCTCACGAC -> GTCTCACGACC
GACACCGCACG -> ACACCGCACGG
TTCGGAGTTAT -> TCGGAGTTATA
CGGGAGAGAAA -> GGGAGAGAAAG
GTCAACATTCT -> TCAACATTCTT
ATCGAACTTAG -> TCGAACTTAGT
CCATTGTAGTC -> CATTGTAGTCA
TCTTTTGACTC -> CTTTTGACTCT
TTTCGGTTGGT -> TTCGGTTGGTC
CTTGCCTAAGA -> TTGCCTAAGAG
CTGGGACCGTA -> TGGGACCGTAT
TCGGAGTTATA -> CGGAGTTATAT
ACATTCTTTTG -> CATTCTTTTGA
TCCGTTAATTC -> CCGTTAATTCT
TATTGATTGGG -> ATTGATTGGGT
CACCGCTTCTC -> ACCGCTTCTCT
AGAATCCATTG -> GAATCCATTGT
TCACACTACGT -> CACACTACGTG
TGGCAGACTTC -> GGCAGACTTCG
ATGGCCCCCTA -> TGGCCCCCTAG
AGATCAGGGAT -> GATCAGGGATG
CCCAGAGACCC -> CCAGAGACCCT
CGGCGGGAGAG -> GGCGGGAGAGA
GTTATATCTGA -> TTATATCTGAA
ATTAGTCCTTG -> TTAGTCCTTGA
TTTATGCGAGA -> TTATGCGAGAG
GACTTCTCTCG -> ACTTCTCTCGA
GCAGTACAACC -> CAGTACAACCG
TGAGTCTTGTC -> GAGTCTTGTCG
ATAGGGCCTCT -> TAGGGCCTCTG
CACCGGGCGAG -> ACCGGGCGAGT
TTGGTGCCTAA -> TGGTGCCTAAG
TCAGCCCTCCA -> CAGCCCTCCAC
CTCAGCTTGCT -> TCAGCTTGCTA
CGAGCGCGTTA -> GAGCGCGTTAC
CCTTTGGTGCC -> CTTTGGTGCCT
GGTGCATAGGG -> GTGCATAGGGC
GGCATAATTCC -> GCATAATTCCA
GGCGTCTGGGA -> GCGTCTGGGAT
AACAAATCTGC -> ACAAATCTGCT
TATGCGGCGGG -> ATGCGGCGGGA
AACCGACTCTT -> ACCGACTCTTA
ATACAAATAGC -> TACAAATAGCG
GTTTCTGCAGG -> TTTCTGCAGGG
CCTGCAGAAAA -> CTGCAGAAAAG
GCAGATCCCTA -> CAGATCCCTAA
GTAATTTTTGA -> TAATTTTTGAG
CAAGTCTACAA -> AAGTCTACAAT
CTTTGAGTAGA -> TTTGAGTAGAT
TCTCACCATTT -> CTCACCATTTT
CTACCAGGGGA -> TACCAGGGGAG
TGTCCCACAAG -> GTCCCACAAGA
CCTAGCGGAGT -> CTAGCGGAGTC
TCCTACTAATA -> CCTACTAATAA
TCCCCGATACG -> CCCCGATACGC
GGCCTGGTAGA -> GCCTGGTAGAA
TATGAGAATGA -> ATGAGAATGAT
CTCGGGAGGAC -> TCGGGAGGACA
TGAGGGACAGG -> GAGGGACAGGT
CGAAAACGTAG -> GAAAACGTAGG
TGCGGCGGGAG -> GCGGCGGGAGA
TGCGACCGAAG -> GCGACCGAAGG
TCTTGGAGGTC -> CTTGGAGGTCT
GAAGAGGGTAG -> AAGAGGGTAGA
CTCGAAAGGTC -> TCGAAAGGTCT
TCTCACGACCA -> CTCACGACCAG
CCCAGTGCTCG -> CCAGTGCTCGA
CATCATAGAGT -> ATCATAGAGTT
GTCCCACAAGA -> TCCCACAAGAC
TGGAGGCAAGT -> GGAGGCAAGTT
ATACGCCACGT -> TACGCCACGTT
CGCTCCCAATT -> GCTCCCAATTC
CGGTTTCTGCA -> GGTTTCTGCAG
ATGTGTCCCAC -> TGTGTCCCACA
TAGATCCATAC -> AGATCCATACC
TCGGACAATGG -> CGGACAATGGC
TCTCTGGTGCG -> CTCTGGTGCGA
AAAGCATATAT -> AAGCATATATT
AGGTATTAACA -> GGTATTAACAC
TGTACCTAAGC -> GTACCTAAGCA
CGACAGAGCTT -> GACAGAGCTTG
GACTGCCTGAA -> ACTGCCTGAAC
GAAGTAATTTT -> AAGTAATTTTT
ATCCTAGCTAC -> TCCTAGCTACC
TTCGGTTGGTC -> TCGGTTGGTCC
TACAAATAGCG -> ACAAATAGCGT
CCGCACGGCCA -> CGCACGGCCAT
AGCGTTTAAGC -> GCGTTTAAGCG
AGAGCTTGCTT -> GAGCTTGCTTC
AAACTCATTAG -> AACTCATTAGG
TGTGTTATCGA -> GTGTTATCGAA
ACGACTTGTAC -> CGACTTGTACC
GCCTCAGCTTG -> CCTCAGCTTGC
AACGGAATCAT -> ACGGAATCATA
TAAGCGGCAAT -> AAGCGGCAATT
TGCCAGCAACA -> GCCAGCAACAT
CAATAAGCGGC -> AATAAGCGGCA
CCTTGATCCCA -> CTTGATCCCAT
GATTCGTGGGT -> ATTCGTGGGTG
ATGTATTGATT -> TGTATTGATTG
TCCCCCTCCCC -> CCCCCTCCCCG
CGGTGTAAATG -> GGTGTAAATGC
ATTGATTGGGT -> TTGATTGGGTA
AAGAAGAGGGT -> AGAAGAGGGTA
CTTTTCCCCCT -> TTTTCCCCCTC
GCAATACGTGA -> CAATACGTGAT
GACTTCGGAAC -> ACTTCGGAACC
AGAGGGTAGAA -> GAGGGTAGAAA
TTCTCTGGTGC -> TCTCTGGTGCG
ATATCTGAATC -> TATCTGAATCG
CGTGACTATAT -> GTGACTATATG
CCTAAGCACTG -> CTAAGCACTGT
CGAACTTAGTA -> GAACTTAGTAT
CCGTACGATAG -> CGTACGATAGC
ACTACGTGTCC -> CTACGTGTCCC
TCGAAAGGTCT -> CGAAAGGTCTG
GTATGCAAGGC -> TATGCAAGGCT
CATAGAGTTTA -> ATAGAGTTTAT
ACCAGTGAACT -> CCAGTGAACTG
CAGGGAATGGC -> AGGGAATGGCC
TTGCATGCCTC -> TGCATGCCTCA
GTCGAAGAATC -> TCGAAGAATCC
CACTGCGGTTA -> ACTGCGGTTAC
TCTGGGATCAG -> CTGGGATCAGC
GGGTACTCTTT -> GGTACTCTTTC
GAGTCGAAGAA -> AGTCGAAGAAT
CAATTCTCCAT -> AATTCTCCATT
TGATTGGGTAC -> GATTGGGTACT
AGGAAGCCCGG -> GGAAGCCCGGA
GGCGGGAGAGA -> GCGGGAGAGAA
AGCGGCAATTC -> GCGGCAATTCT
AGGGGAGGTTA -> GGGGAGGTTAG
AGGCTCTCGCT -> GGCTCTCGCTC
AGGATCGAGGG -> GGATCGAGGGA
GCAGCCGTGCC -> CAGCCGTGCCG
TTAGTATGACG -> TAGTATGACGA
GATAGTGCTAT -> ATAGTGCTATG
ATACGTGATTC -> TACGTGATTCC
AGGGACAGGTA -> GGGACAGGTAT
TAAGATACCTT -> AAGATACCTTT
GGGACGGTTTC -> GGACGGTTTCG
GCATAGGGCCT -> CATAGGGCCTC
TAGCGATAGTG -> AGCGATAGTGC
TCCTAAATCCT -> CCTAAATCCTG
ATTGCGACTGT -> TTGCGACTGTT
GCTAGGAACGC -> CTAGGAACGCA
GAACAAATCTG -> AACAAATCTGC
GAGTCCAAAGG -> AGTCCAAAGGC
ACCTATGATAG -> CCTATGATAGC
GTTCTAAGATA -> TTCTAAGATAC
ACGGAACGTTC -> CGGAACGTTCT
ATCGAGGGACG -> TCGAGGGACGA
CGGTTTCGGAC -> GGTTTCGGACA
GGACGAGCGAC -> GACGAGCGACT
GTCTGCAGTAT -> TCTGCAGTATC
GATACGCCACG -> ATACGCCACGT
TTTCCCACGCC -> TTCCCACGCCG
GGTCTATCTTT -> GTCTATCTTTT
TAGAAAGCATA -> AGAAAGCATAT
CTCGCATCACT -> TCGCATCACTG
TGACGCGACTG -> GACGCGACTGC
ACGGTTTCGGA -> CGGTTTCGGAC
AATCCTGTTTC -> ATCCTGTTTCG
GTACTCTTTCC -> TACTCTTTCCC
TTGAGTGATGT -> TGAGTGATGTC
GTCTTGTCGGT -> TCTTGTCGGTC
TCTGCAGGGAA -> CTGCAGGGAAT
AGGATGAGTAG -> GGATGAGTAGA
AATCTGCTACT -> ATCTGCTACTC
GAACGGAACGT -> AACGGAACGTT
GGTTATGCGGC -> GTTATGCGGCG
AAGCATATATT -> AGCATATATTT
ACGAAAAACTC -> CGAAAAACTCA
TAAGCGGAGTC -> AAGCGGAGTCC
GGCGAGTACAA -> GCGAGTACAAT
AGAGTTTATGC -> GAGTTTATGCG
ATGCCTCAGCT -> TGCCTCAGCTT
AATAAGTTGGC -> ATAAGTTGGCA
CAATTCGGAGT -> AATTCGGAGTT
CTGAATACAGG -> TGAATACAGGA
AGATAGCGCTC -> GATAGCGCTCC
CTCATTAGGGG -> TCATTAGGGGT
TAAGGTGAAGG -> AAGGTGAAGGC
TTGGTCCCAGT -> TGGTCCCAGTG
TTAGCAGCATA -> TAGCAGCATAC
TCCTGAGGCCT -> CCTGAGGCCTC
CCGAAGGGAGG -> CGAAGGGAGGC
ACCTAAGCACT -> CCTAAGCACTG
CGCACTGTTGC -> GCACTGTTGCC
AGATCCATACC -> GATCCATACCT
CGTCCATTCCC -> GTCCATTCCCC
CTGGCGTCTGG -> TGGCGTCTGGG
CATAATAGAAA -> ATAATAGAAAC
TACTCGCATCA -> ACTCGCATCAC
CTCATACCTTC -> TCATACCTTCT
TTATATCTGAA -> TATATCTGAAT
TGATGTCACGT -> GATGTCACGTG
CATGAGTCAGC -> ATGAGTCAGCC
GGGGACGGTTT -> GGGACGGTTTC
CTATGGAGCAC -> TATGGAGCACC
TGAGGTCGTAA -> GAGGTCGTAAT
TGTGTCCCACA -> GTGTCCCACAA
GGTCCCCGATA -> GTCCCCGATAC
ACTTAGTATGA -> CTTAGTATGAC
CAAGACACCGC -> AAGACACCGCA
CCGGTTTCTGC -> CGGTTTCTGCA
TATATCTGAAT -> ATATCTGAATC
CACGTCTGCAG -> ACGTCTGCAGT
CGGAACGTTCT -> GGAACGTTCTA
CTATTTCCGAG -> TATTTCCGAGG
AAGAACAGATT -> AGAACAGATTC
TTGATCCCATA -> TGATCCCATAT
GTTTCGGTTGG -> TTTCGGTTGGT
ACACGAAAGGA -> CACGAAAGGAC
GTCGTAATGCG -> TCGTAATGCGG
CACACTGTGAA -> ACACTGTGAAG
AGCGACTGAGG -> GCGACTGAGGG
GACGCTGCCTG -> ACGCTGCCTGT
ACGTTATGAGG -> CGTTATGAGGT
GTAGATCCATA -> TAGATCCATAC
ATCCATACCTT -> TCCATACCTTT
TGCGGTTACCT -> GCGGTTACCTT
CCCCGAATTCA -> CCCGAATTCAT
TGCTATGAGAA -> GCTATGAGAAT
TATGCGACCGA -> ATGCGACCGAA
CATAAACGAGC -> ATAAACGAGCG
GGGCCTCTGAC -> GGCCTCTGACG
TTCCCCGAATT -> TCCCCGAATTC
TTTTCCCCCTC -> TTTCCCCCTCC
CCACCGGGCGA -> CACCGGGCGAG
GCATTACTACT -> CATTACTACTA
CCCCTAGTACC -> CCCTAGTACCC
TATCTTTTCAA -> ATCTTTTCAAA
AAATCTGCTAC -> AATCTGCTACT
CGGGTCTATCT -> GGGTCTATCTT
TGAGTCAGCCC -> GAGTCAGCCCT
CTTCAGGACCT -> TTCAGGACCTC
AAGTGGATCCT -> AGTGGATCCTA
ATCGAAAACGT -> TCGAAAACGTA
AAAAGGGGACG -> AAAGGGGACGG
GAGAATGATGT -> AGAATGATGTT
GTAGAAAGCAT -> TAGAAAGCATA
AGTGATGTCAC -> GTGATGTCACG
AAGCAGACTAC -> AGCAGACTACA
AGTTGGCATAA -> GTTGGCATAAT
CAGCCGTGCCG -> AGCCGTGCCGT
GAATCCGAAGA -> AATCCGAAGAA
CCTATGATAGC -> CTATGATAGCA
GAGTACAATTA -> AGTACAATTAT
TTCCTGAGGCC -> TCCTGAGGCCT
TTTTGAGTGAT -> TTTGAGTGATG
GATGTTTCTTG -> ATGTTTCTTGG
TCGAAGTCAGA -> CGAAGTCAGAA
CGGTTGCAGCC -> GGTTGCAGCCG
ATAAGCGGCAA -> TAAGCGGCAAT
AACGTCAACAT -> ACGTCAACATT
GCCCCCTAGTA -> CCCCCTAGTAC
TCTACAATGAA -> CTACAATGAAT
GTTCTGGATAG -> TTCTGGATAGC
GTGCGAAGTAA -> TGCGAAGTAAT
GGAATGGCCCC -> GAATGGCCCCC
TCCTGTCGAGG -> CCTGTCGAGGG
CGAGAGTGCTC -> GAGAGTGCTCA
CAGCCTGAGGA -> AGCCTGAGGAA
GTGACGCGGTC -> TGACGCGGTCC
AACACATATGA -> ACACATATGAT
AGACTACAAAC -> GACTACAAACG
GATCCAGCGCA -> ATCCAGCGCAG
CACAAGACACC -> ACAAGACACCG
TAGAACCTATG -> AGAACCTATGA
GTACAACCGAC -> TACAACCGACT
GGAGTTATATC -> GAGTTATATCT
GTCATCCTAGC -> TCATCCTAGCT
TATCGAAAACG -> ATCGAAAACGT
CCTAAATCCTG -> CTAAATCCTGT
AGGCCTCCCGT -> GGCCTCCCGTC
AGTCCTTGATC -> GTCCTTGATCC
GAGATGTTTCT -> AGATGTTTCTT
AGTGCTCATAC -> GTGCTCATACC
AGCATACAAAT -> GCATACAAATA
TCGAGGGCGAG -> CGAGGGCGAGG
GTGTGTCGTCG -> TGTGTCGTCGC
AAGCGGAGTCC -> AGCGGAGTCCA
GTAGAGAAACG -> TAGAGAAACGG
ATATTTGCCAC -> TATTTGCCACC
GTGTCCCACAA -> TGTCCCACAAG
ATTTAGGGGCG -> TTTAGGGGCGT
CGTCTATCGTC -> GTCTATCGTCC
ACTCTCACCAT -> CTCTCACCATT
TAGTATGACGA -> AGTATGACGAA
GGGAGGACACA -> GGAGGACACAC
CGGGTTATGCG -> GGGTTATGCGG
GTTATCGAAAA -> TTATCGAAAAC
CTACTCGCATC -> TACTCGCATCA
CTGGTGCGAAG -> TGGTGCGAAGT
CTCCTGGACGG -> TCCTGGACGGC
TCCGGTCCCCG -> CCGGTCCCCGA
CCTGAACGGAA -> CTGAACGGAAC
CTGACGCGACT -> TGACGCGACTG
GGCCCCCTAGT -> GCCCCCTAGTA
TTCCAATAAGC -> TCCAATAAGCG
GATTGGGTACT -> ATTGGGTACTC
TGTTCTGGATA -> GTTCTGGATAG
GAGGACACACG -> AGGACACACGA
CTCTGGTGCGA -> TCTGGTGCGAA
AGGGCCTCTGA -> GGGCCTCTGAC
GAGAAACGGAA -> AGAAACGGAAT
TACAATGAATT -> ACAATGAATTA
ATAAGTTGGCA -> TAAGTTGGCAT
GATACCCCATG -> ATACCCCATGA
AACAGATTCGT -> ACAGATTCGTG
CAGGATCGAGG -> AGGATCGAGGG
CCTTTTCCCCC -> CTTTTCCCCCT
AGAAAAGGGGA -> GAAAAGGGGAC
AGGAACGCACT -> GGAACGCACTG
TTAGGGTTTCA -> TAGGGTTTCAG
AATACACTTAG -> ATACACTTAGG
TGGGACCGTAT -> GGGACCGTATG
CCGACGCTGCC -> CGACGCTGCCT
CCCACAAGACA -> CCACAAGACAC
GAGACTTCAGG -> AGACTTCAGGA
ACGACCAGTGA -> CGACCAGTGAA
GCATAAGGTGA -> CATAAGGTGAA
TATTTCCGAGG -> ATTTCCGAGGT
AACGTAGGTAG -> ACGTAGGTAGA
AATCAGTAAGT -> ATCAGTAAGTG
GCGAGAGTGCT -> CGAGAGTGCTC
GTGATTCCCAA -> TGATTCCCAAT
GTTAATTCTCA -> TTAATTCTCAG
GTCTATCTTTT -> TCTATCTTTTC
CCTGGACGGCC -> CTGGACGGCCG
CGCCCTTTCGA -> GCCCTTTCGAG
CGTGGGTGGGA -> GTGGGTGGGAC
CTAGATCGAAG -> TAGATCGAAGT
CTCGGGTTATG -> TCGGGTTATGC
CTGTAGATCCA -> TGTAGATCCAT
GTTTCAGAATC -> TTTCAGAATCA
GCGACCGAAGG -> CGACCGAAGGG
CATCACATGTC -> ATCACATGTCT
TCCTAGCTACC -> CCTAGCTACCA
TTGTACCTAAG -> TGTACCTAAGC
CAAGGCTCTCG -> AAGGCTCTCGC
TCTTTTCAAAC -> CTTTTCAAACC
TTATATTTGCC -> TATATTTGCCA
CACCGCACGGC -> ACCGCACGGCC
CAGGTATTAAC -> AGGTATTAACA
CCCTAGTACCC -> CCTAGTACCCA
AGATCGAAGTC -> GATCGAAGTCA
CGGCAATTCTC -> GGCAATTCTCC
TAAGAGACTTC -> AAGAGACTTCA
TAAGCACTGTC -> AAGCACTGTCC
CGACTGCCTGA -> GACTGCCTGAA
GAAAAGGGGAC -> AAAAGGGGACG
TCGCTTCTCGG -> CGCTTCTCGGT
TTTTCAAACCA -> TTTCAAACCAC
GTGGCGAGTAT -> TGGCGAGTATT
TTACTACTATG -> TACTACTATGG
CGGTGTGTCGT -> GGTGTGTCGTC
GACAATGGCAG -> ACAATGGCAGA
CGAGTACAATT -> GAGTACAATTA
CACTGTGAAGC -> ACTGTGAAGCG
TGTTTCTTGGA -> GTTTCTTGGAG
AGTGCCGCACC -> GTGCCGCACCG
TGTTATCGAAA -> GTTATCGAAAA
GGGTTCGACAG -> GGTTCGACAGA
CCGTTAATTCT -> CGTTAATTCTC
CCAAAGGCCAT -> CAAAGGCCATC
CCATGGGCCGC -> CATGGGCCGCA
CCGTGCCGTAC -> CGTGCCGTACG
AGAATGATGTT -> GAATGATGTTG
CTCCCTCGGGT -> TCCCTCGGGTT
GCATATATTTC -> CATATATTTCT
TGAACTGGAGG -> GAACTGGAGGC
CCCTCGGGTTA -> CCTCGGGTTAT
ACTGTCCGGGT -> CTGTCCGGGTG
TGCAGTATCGT -> GCAGTATCGTC
GTTGCCGACTT -> TTGCCGACTTC
ACCCCATGAGT -> CCCCATGAGTC
TCCTGTGTTAT -> CCTGTGTTATC
ATCTACTAGCG -> TCTACTAGCGA
TCCAAAGGCCA -> CCAAAGGCCAT
CAACATATGGA -> AACATATGGAT
CTGTGTTATCG -> TGTGTTATCGA
ACCCTTTTCCC -> CCCTTTTCCCC
AGAGAAACGGA -> GAGAAACGGAA
CTGCAGGGAAT -> TGCAGGGAATG
TTCGAACTTAT -> TCGAACTTATG
CTCACGACCAG -> TCACGACCAGT
CGCTCCCGGAC -> GCTCCCGGACT
CGATAGTGCTA -> GATAGTGCTAT
AGGCCACGAGA -> GGCCACGAGAT
GGTGGCCTCCC -> GTGGCCTCCCT
AATTCTCAGAA -> ATTCTCAGAAT
GAGAGAAAGAG -> AGAGAAAGAGG
TCTGGTGCGAA -> CTGGTGCGAAG
CGCTTCTCGGT -> GCTTCTCGGTT
CCAGCGCAGTA -> CAGCGCAGTAC
TGTCGTCGCTT -> GTCGTCGCTTC
AAATCCTGTTT -> AATCCTGTTTC
TCAGGACCTCG -> CAGGACCTCGC
GGTCCCAGTGC -> GTCCCAGTGCT
GTGAAGGCAAT -> TGAAGGCAATA
GAGGCAAGTTG -> AGGCAAGTTGA
GGATCGAGGGA -> GATCGAGGGAC
GCGGTTACCTT -> CGGTTACCTTG
CGGAGTGCCGC -> GGAGTGCCGCA
GCGGTCCGGTC -> CGGTCCGGTCC
AGCGCTCCCGG -> GCGCTCCCGGA
TGTTCGGGTTC -> GTTCGGGTTCG
GCCACCCTTTT -> CCACCCTTTTC
TGCTACTCGCA -> GCTACTCGCAT
TATCCGTTAAT -> ATCCGTTAATT
TCGGTCTTCGA -> CGGTCTTCGAA
GGGATGTATTG -> GGATGTATTGA
ATTCCCAATCT -> TTCCCAATCTA
CTTATTGAGTC -> TTATTGAGTCT
GTTGGCATAAT -> TTGGCATAATT
GTCGCTTCTCG -> TCGCTTCTCGG
GATATTCCTAT -> ATATTCCTATA
GGTACTCTTTC -> GTACTCTTTCC
CCGCTCGCTCC -> CGCTCGCTCCC
TGGCGAGTATT -> GGCGAGTATTC
ACCTCGCCGCG -> CCTCGCCGCGC
ATGCCATGGGC -> TGCCATGGGCC
CGAGTATTCGG -> GAGTATTCGGG
GACCTCGCCGC -> ACCTCGCCGCG
TCATAATAGAA -> CATAATAGAAA
GGAACGTTCTA -> GAACGTTCTAA
TCATCACATGT -> CATCACATGTC
AGTACAATTAT -> GTACAATTATA
GAGCGCGTTAC -> AGCGCGTTACC
GCAGGGAATGG -> CAGGGAATGGC
TATATATTCTA -> ATATATTCTAA
TAGTGCTATGA -> AGTGCTATGAG
GACTGAGGGAC -> ACTGAGGGACA
GTCGTCGCTTC -> TCGTCGCTTCT
TCGCCGGACAG -> CGCCGGACAGG
CCCCCTAGTAC -> CCCCTAGTACC
TGGTCCCAGTG -> GGTCCCAGTGC
ATAAACGAGCG -> TAAACGAGCGC
GACTTCAGGAC -> ACTTCAGGACC
GAAACATGTTC -> AAACATGTTCG
CTACAAACGTC -> TACAAACGTCA
GAATCGCCGGA -> AATCGCCGGAC
ATAATTCCAAT -> TAATTCCAATA
TTCGGAACCGG -> TCGGAACCGGT
CCGAAGAAGAG -> CGAAGAAGAGG
ACTTCTCTCGA -> CTTCTCTCGAA
GGAACCGGTTT -> GAACCGGTTTC
AGAACCTGCAG -> GAACCTGCAGA
GAGGCACCAGT -> AGGCACCAGTA
GAACCTGCAGA -> AACCTGCAGAA
TTGCCGACTTC -> TGCCGACTTCT
TAGATCGAAGT -> AGATCGAAGTC
CGCAGTACAAC -> GCAGTACAACC
GAACGCACTGT -> AACGCACTGTT
TCTACTAGCGA -> CTACTAGCGAT
TATTAACACAT -> ATTAACACATA
GGGACAGGTAT -> GGACAGGTATT
CAGAACCTGCA -> AGAACCTGCAG
CCGACTCTTAT -> CGACTCTTATT
GATAGCATTAC -> ATAGCATTACT
TGATTCCCAAT -> GATTCCCAATC
TATATTTGCCA -> ATATTTGCCAC
TAAGTTGGCAT -> AAGTTGGCATA
AGTCAGCCCTC -> GTCAGCCCTCC
TGCCGTACGAT -> GCCGTACGATA
TGCGAAGTAAT -> GCGAAGTAATT
GAACAGATTCG -> AACAGATTCGT
CCTAAGAGACT -> CTAAGAGACTT
CTTCCTGAGGC -> TTCCTGAGGCC
CGTCCTGTCGA -> GTCCTGTCGAG
AAGTTGAAGCC -> AGTTGAAGCCG
CAGGACCTCGC -> AGGACCTCGCC
TGAGTAGATAG -> GAGTAGATAGC
TTCGGACAATG -> TCGGACAATGG
CGACGCTGCCT -> GACGCTGCCTG
AAAGGACGACT -> AAGGACGACTT
TTGCCTAAGAG -> TGCCTAAGAGA
GTCGAGGGCGA -> TCGAGGGCGAG
CCGACTTCTCT -> CGACTTCTCTC
CATGCCTCAGC -> ATGCCTCAGCT
CAAGTTGAAGC -> AAGTTGAAGCC
GACGGTTTCGG -> ACGGTTTCGGA
AAGGACGACTT -> AGGACGACTTG
ACGGAATCATA -> CGGAATCATAA
GGACTATTTCC -> GACTATTTCCG
GCGCAGTACAA -> CGCAGTACAAC
ATACAGGATGA -> TACAGGATGAG
GCGAGGCACCA -> CGAGGCACCAG
CTGCGGTTACC -> TGCGGTTACCT
GACGGCCGACG -> ACGGCCGACGC
GCACCAGTAAG -> CACCAGTAAGA
CCCACGCCGCT -> CCACGCCGCTC
CGAAGAAGAGG -> GAAGAAGAGGG
TTGATTGGGTA -> TGATTGGGTAC
TACTCTTTCCC -> ACTCTTTCCCA
CTGGCCTTTGA -> TGGCCTTTGAA
CGACTTCTCTC -> GACTTCTCTCG
TTGCTTCGAAC -> TGCTTCGAACT
TGAATCGCCGG -> GAATCGCCGGA
GAGTTATATCT -> AGTTATATCTG
CATTTTACGGC -> ATTTTACGGCA
GGGTCTATCTT -> GGTCTATCTTT
TCTCGCTCGGG -> CTCGCTCGGGA
AGCATTACTAC -> GCATTACTACT
CTAGTACCCAT -> TAGTACCCATC
CGGAATCATAA -> GGAATCATAAA
AGTATCGTCCT -> GTATCGTCCTG
ATTCCCCGAAT -> TTCCCCGAATT
GACTCTCACCA -> ACTCTCACCAT
GTCCGGTCCCC -> TCCGGTCCCCG
GCTCTCGCTCG -> CTCTCGCTCGG
ATTATGCGACC -> TTATGCGACCG
CATATACGTAT -> ATATACGTATC
GATCCATACCT -> ATCCATACCTT
AGTCTTGTCGG -> GTCTTGTCGGT
GTCTGGGATCA -> TCTGGGATCAG
CCTGAGGAAGC -> CTGAGGAAGCC
ATAGCATTACT -> TAGCATTACTA
ATTAACACATA -> TTAACACATAT
ATCCTGTTTCG -> TCCTGTTTCGG
CCAATCTACTA -> CAATCTACTAG
TCCCCGGTGTA -> CCCCGGTGTAA
CGATACCCCAT -> GATACCCCATG
GCATACAAATA -> CATACAAATAG
CTGTTGCCGAC -> TGTTGCCGACT
CCAGTAAGATG -> CAGTAAGATGT
TCGGGTCTATC -> CGGGTCTATCT
GAGCGACTGAG -> AGCGACTGAGG
ACAGGTATTAA -> CAGGTATTAAC
GAAGCCCGGAG -> AAGCCCGGAGT
AAATAGCGTTT -> AATAGCGTTTA
CGCACGGCCAT -> GCACGGCCATT
TCCACCGGGCG -> CCACCGGGCGA
TCGTCCTGTCG -> CGTCCTGTCGA
GTAAGATGTGT -> TAAGATGTGTC
GATCGAAGTCA -> ATCGAAGTCAG
TTCTCCTGGAC -> TCTCCTGGACG
GCCATCCAATT -> CCATCCAATTC
ACAACCGACTC -> CAACCGACTCT
ACCAGTAAGAT -> CCAGTAAGATG
GCGGCGGGAGA -> CGGCGGGAGAG
CGCGACTGCCT -> GCGACTGCCTG
CTTCTTGCCAG -> TTCTTGCCAGC
ACGTCTGCAGT -> CGTCTGCAGTA
CGAGCGACTGA -> GAGCGACTGAG
GACTATTTCCG -> ACTATTTCCGA
AACGAGCGCGT -> ACGAGCGCGTT
GGGGAGGTTAG -> GGGAGGTTAGC
CCCGGACTATT -> CCGGACTATTT
TCCCGGACTAT -> CCCGGACTATT
GATGTATTGAT -> ATGTATTGATT
TCGCTCGGGAG -> CGCTCGGGAGG
CAACATTCTTT -> AACATTCTTTT
CCCGGAGTGCC -> CCGGAGTGCCG
TTGAAGTAACA -> TGAAGTAACAG
CGGTTACCTTG -> GGTTACCTTGC
TGTTGAAATGT -> GTTGAAATGTG
ATGTTCTGGAT -> TGTTCTGGATA
CACGGCCATTG -> ACGGCCATTGC
CCGTCTATCGT -> CGTCTATCGTC
CACGTGACGCG -> ACGTGACGCGG
AAATCAGTAAG -> AATCAGTAAGT
TCCTATATATA -> CCTATATATAT
GAAAACGTAGG -> AAAACGTAGGT
CCTCCCTCGGG -> CTCCCTCGGGT
CGCCACGTTAT -> GCCACGTTATG
CGCCGCTCGCT -> GCCGCTCGCTC
GCCTGTAGATC -> CCTGTAGATCC
TCGGGAGGACA -> CGGGAGGACAC
TTCCCCCTCCC -> TCCCCCTCCCC
TTCTTTTGACT -> TCTTTTGACTC
GAGAGTGCTCA -> AGAGTGCTCAT
GAGTCAGCCCT -> AGTCAGCCCTC
TAGGGGTCCTT -> AGGGGTCCTTC
CACTACGTGTC -> ACTACGTGTCC
GGGCCGCATCA -> GGCCGCATCAT
ATCATCACATG -> TCATCACATGT
GTGTTATCGAA -> TGTTATCGAAA
GGGAGGTTAGC -> GGAGGTTAGCA
TACCTTTGGTG -> ACCTTTGGTGC
GTCTGGCGTCT -> TCTGGCGTCTG
ATTCCTATATA -> TTCCTATATAT
CCTGTCGAGGG -> CTGTCGAGGGC
AGATTCGTGGG -> GATTCGTGGGT
TTTCAAACCAC -> TTCAAACCACG
TCCGAGGTAGT -> CCGAGGTAGTT
TCGTAATGCGG -> CGTAATGCGGT
GCTATGAGAAT -> CTATGAGAATG
CCCTAGCGGAG -> CCTAGCGGAGT
TGAATACAGGA -> GAATACAGGAT
TGCGAGAGTGC -> GCGAGAGTGCT
GGTTTCGGACA -> GTTTCGGACAA
ATTCGGAGTTA -> TTCGGAGTTAT
GAAGAAGAGGG -> AAGAAGAGGGT
CAATACGTGAT -> AATACGTGATT
TTTAGGGGCGT -> TTAGGGGCGTC
GAAAGGTCTGG -> AAAGGTCTGGC
AGGTAGATCAG -> GGTAGATCAGG
GTTATGCGGCG -> TTATGCGGCGG
GTGCTCGAAAG -> TGCTCGAAAGG
GTGGGACGAAA -> TGGGACGAAAA
TTTGACTCTCA -> TTGACTCTCAC
GTCGTGACTAT -> TCGTGACTATA
ACTTCAGGACC -> CTTCAGGACCT
GGACAGGTATT -> GACAGGTATTA
TCTATCTTTTC -> CTATCTTTTCA
ATGATCCAGCG -> TGATCCAGCGC
ACATGTTCGGG -> CATGTTCGGGT
ATCTGAATCGC -> TCTGAATCGCC
TGCCGACTTCT -> GCCGACTTCTC
GGTAGATCAGG -> GTAGATCAGGG
GATCCCTAAAG -> ATCCCTAAAGA
CCATTGCGACT -> CATTGCGACTG
TGAAGTAACAG -> GAAGTAACAGA
TTCGGGTTCGA -> TCGGGTTCGAC
AGCTAATCCTG -> GCTAATCCTGT
ACAAATCTGCT -> CAAATCTGCTA
CCTAAAGATTA -> CTAAAGATTAG
ATAGCGTTTAA -> TAGCGTTTAAG
GTGAACTGGAG -> TGAACTGGAGG
ATGAGTCAGCC -> TGAGTCAGCCC
CTGTTTCCTAC -> TGTTTCCTACT
ATACACTTAGG -> TACACTTAGGG
ACGAGCGCGTT -> CGAGCGCGTTA
GGGCGAGTACA -> GGCGAGTACAA
TCTGCTACTCG -> CTGCTACTCGC
GGAGGACACAC -> GAGGACACACG
CCGAATTCATA -> CGAATTCATAA
CGGACAATGGC -> GGACAATGGCA
GAAGGGAGGCC -> AAGGGAGGCCA
TCTTCGAACAA -> CTTCGAACAAA
TGATAGCATTA -> GATAGCATTAC
AGTTTATGCGA -> GTTTATGCGAG
ACCTTTACCTT -> CCTTTACCTTT
CGCGTTACCCT -> GCGTTACCCTT
GGCACCAGTAA -> GCACCAGTAAG
ATAGTGCTATG -> TAGTGCTATGA
CTTATGCCATG -> TTATGCCATGG
AACCGGTTTCT -> ACCGGTTTCTG
CGTTACCCTTC -> GTTACCCTTCG
AGCCGATCATC -> GCCGATCATCA
CAGAAAAGGGG -> AGAAAAGGGGA
CAAATAGCGTT -> AAATAGCGTTT
AGATTAGTCCT -> GATTAGTCCTT
GCGGAGTCGAA -> CGGAGTCGAAG
TCTCAGAATCC -> CTCAGAATCCG
TAGCTGAATAC -> AGCTGAATACA
AGTATTCGGGT -> GTATTCGGGTC
AATCCATTGTA -> ATCCATTGTAG
TCTTGTCGGTC -> CTTGTCGGTCT
AGTGGATCCTA -> GTGGATCCTAA
ACCCTAGCGGA -> CCCTAGCGGAG
GGAACGCACTG -> GAACGCACTGT
TGCCTCAGCTT -> GCCTCAGCTTG
AACTGGAGGCA -> ACTGGAGGCAA
TTCTCCATTTA -> TCTCCATTTAG
GTATCGTCCTG -> TATCGTCCTGT
TCGTCCATTCC -> CGTCCATTCCC
TGGATAGCTCA -> GGATAGCTCAC
GAACCGGTTTC -> AACCGGTTTCT
GAGGTCGTAAT -> AGGTCGTAATG
GGGTGGCCTCC -> GGTGGCCTCCC
GCCTCCCTCGG -> CCTCCCTCGGG
TGTTGCATGCC -> GTTGCATGCCT
AATTCTGGCCT -> ATTCTGGCCTT
AATGCGGTGCA -> ATGCGGTGCAT
AGCGGAGTCGA -> GCGGAGTCGAA
AGGGATGTATT -> GGGATGTATTG
CCAATAAGCGG -> CAATAAGCGGC
CTTAGGGTTTC -> TTAGGGTTTCA
CCCGTCTATCG -> CCGTCTATCGT
ACACCGCACGG -> CACCGCACGGC
TGCATGCCTCA -> GCATGCCTCAG
GAGGGACGAGC -> AGGGACGAGCG
GTAAATGCTGG -> TAAATGCTGGG
GGTCCGGTCCC -> GTCCGGTCCCC
ACCGTATGCAA -> CCGTATGCAAG
GGACACACGAA -> GACACACGAAA
TTATGAGGTCG -> TATGAGGTCGT
CTATCTTTTCA -> TATCTTTTCAA
GACGACTTGTA -> ACGACTTGTAC
AAGACGGCACT -> AGACGGCACTG
CTGGTAGAACC -> TGGTAGAACCT
CCTACTAATAA -> CTACTAATAAG
GCTGAATACAG -> CTGAATACAGG
GATCCTAAATC -> ATCCTAAATCC
TAGTCATCCTA -> AGTCATCCTAG
AGACCCTAGCG -> GACCCTAGCGG
TTCTCTCGAAA -> TCTCTCGAAAT
TCAGCTTGCTA -> CAGCTTGCTAG
GGACGGCCGAC -> GACGGCCGACG
CCGCATCATAG -> CGCATCATAGA
ACAGAGCTTGC -> CAGAGCTTGCT
GACACACGAAA -> ACACACGAAAG
ATAAGGTGAAG -> TAAGGTGAAGG
ATACCTTCTTG -> TACCTTCTTGC
ACTGCCTGAAC -> CTGCCTGAACG
GAATGGCCCCC -> AATGGCCCCCT
TCACATGTCTC -> CACATGTCTCC
ACTCGCATCAC -> CTCGCATCACT
CATTTAGGGGC -> ATTTAGGGGCG
GGACGGTTTCG -> GACGGTTTCGG
AGGCAATACGT -> GGCAATACGTG
ACTAATAAGTT -> CTAATAAGTTG
GCCTAAGAACA -> CCTAAGAACAG
ACTTGTACCTA -> CTTGTACCTAA
ATAGAAACATG -> TAGAAACATGT
TTTGAAGTAAC -> TTGAAGTAACA
CGTCGCTTCTC -> GTCGCTTCTCG
CTCCATTTAGG -> TCCATTTAGGG
TTTTTGAGTGA -> TTTTGAGTGAT
TCGGTTGCAGC -> CGGTTGCAGCC
GTCCCAGAGAC -> TCCCAGAGACC
GTTACCTTGCC -> TTACCTTGCCT
TCGGGTTATGC -> CGGGTTATGCG
CCGCGCAGATC -> CGCGCAGATCC
CTCACCATTTT -> TCACCATTTTA
CACTTAGGGTT -> ACTTAGGGTTT
CACCAGTAAGA -> ACCAGTAAGAT
ACCCATCACGG -> CCCATCACGGT
CTGAGGAAGCC -> TGAGGAAGCCC
CTAGGAACGCA -> TAGGAACGCAC
CGTTCTAAGAT -> GTTCTAAGATA
CTTTTGACTCT -> TTTTGACTCTC
CGAGGGACGAG -> GAGGGACGAGC
GTTATGAGGTC -> TTATGAGGTCG
AGTTATATCTG -> GTTATATCTGA
TATATTCTAAA -> ATATTCTAAAG
CACACGAAAGG -> ACACGAAAGGA
GAGTGATGTCA -> AGTGATGTCAC
TTTCAGAATCA -> TTCAGAATCAC
TTCGCCCTTTC -> TCGCCCTTTCG
CTTGGAGGTCT -> TTGGAGGTCTC
AATAAGCGGCA -> ATAAGCGGCAA
ACGTATCCGTT -> CGTATCCGTTA
GAGCACCGCTT -> AGCACCGCTTC
AGCGCGTTACC -> GCGCGTTACCC
AAGTCTACAAT -> AGTCTACAATG
CTCGCTCCCAA -> TCGCTCCCAAT
CACGAAAGGAC -> ACGAAAGGACG
GGAGTCGAAGA -> GAGTCGAAGAA
GTGGCCTCCCT -> TGGCCTCCCTC
AGTCAGAAGCA -> GTCAGAAGCAT
GGGAGGCCACG -> GGAGGCCACGA
TGGCCTCCCTC -> GGCCTCCCTCG
CCTGTGTTATC -> CTGTGTTATCG
ACTGTTGCCGA -> CTGTTGCCGAC
AACATTCTTTT -> ACATTCTTTTG
GTATCCGTTAA -> TATCCGTTAAT
ATTCTTTTGAC -> TTCTTTTGACT
GCGAGTACAAT -> CGAGTACAATT
CCCGAATTCAT -> CCGAATTCATA
GGGCGTCGTGA -> GGCGTCGTGAC
GGAGGCAAGTT -> GAGGCAAGTTG
TGTCGAGGGCG -> GTCGAGGGCGA
GTAGTCATCCT -> TAGTCATCCTA
CCCTCCCCGGT -> CCTCCCCGGTG
CTGAGGGACAG -> TGAGGGACAGG
TAGAAACATGT -> AGAAACATGTT
AGACTTCGGAA -> GACTTCGGAAC
GTTTATGCGAG -> TTTATGCGAGA
CCGTGTTGCAT -> CGTGTTGCATG
GCCAGCAACAT -> CCAGCAACATA
ATTTCCGAGGT -> TTTCCGAGGTA
GAATTATGCGA -> AATTATGCGAC
GCACTGTCCGG -> CACTGTCCGGG
ACACTGTGAAG -> CACTGTGAAGC
TCGCCGCGCAG -> CGCCGCGCAGA
ATTCTCAGAAT -> TTCTCAGAATC
ACGGCCATTGC -> CGGCCATTGCG
AGTCCAAAGGC -> GTCCAAAGGCC
CACGGTGTGTC -> ACGGTGTGTCG
TTTCCCCCTCC -> TTCCCCCTCCC
ATGGATATTCC -> TGGATATTCCT
AATGAATTATG -> ATGAATTATGC
GTATTGATTGG -> TATTGATTGGG
CCTCGGGTTAT -> CTCGGGTTATG
GCGACTGAGGG -> CGACTGAGGGA
ATCAGGGATGT -> TCAGGGATGTA
CCATCCAATTC -> CATCCAATTCT
TACAAACGTCA -> ACAAACGTCAA
AGGTCGTAATG -> GGTCGTAATGC
GGAGGTTAGCA -> GAGGTTAGCAG
GGCTCTCGCTC -> GCTCTCGCTCG
ACAAACGTCAA -> CAAACGTCAAC
CTCTGACGCGA -> TCTGACGCGAC
AGGACACACGA -> GGACACACGAA
GCCACGAGATG -> CCACGAGATGT
CGAAGAATCCA -> GAAGAATCCAT
AGTAATTTTTG -> GTAATTTTTGA
ACGCTGCCTGT -> CGCTGCCTGTA
CGGGAGGACAC -> GGGAGGACACA
TCTCGAAATCA -> CTCGAAATCAG
TTTACCTTTGA -> TTACCTTTGAG
GGGGTCCTTCC -> GGGTCCTTCCT
AAGTCAGAAGC -> AGTCAGAAGCA
AGATCCCTAAA -> GATCCCTAAAG
CGAACAAATCT -> GAACAAATCTG
ACCGCTTCTCT -> CCGCTTCTCTG
CTAAAGATTAG -> TAAAGATTAGT
GAAAGAGGCTA -> AAAGAGGCTAG
TACTAGCGATA -> ACTAGCGATAG
CCGGACAGGAT -> CGGACAGGATC
GAGCTTGCTTC -> AGCTTGCTTCG
GCGAGTATTCG -> CGAGTATTCGG
GATGTTGAAAT -> ATGTTGAAATG
CTTTCGAGCAA -> TTTCGAGCAAG
CGGAGTCGAAG -> GGAGTCGAAGA
TATGATAGCAT -> ATGATAGCATT
CTTGCTAGATC -> TTGCTAGATCG
GACTATATGTT -> ACTATATGTTC
CAGGATGAGTA -> AGGATGAGTAG
CACGTTATGAG -> ACGTTATGAGG
TGAAGCGATAC -> GAAGCGATACC
GGTTTCTGCAG -> GTTTCTGCAGG
GGCCGCATCAT -> GCCGCATCATA
TGAAATGTGGC -> GAAATGTGGCG
CATTGTAGTCA -> ATTGTAGTCAT
ACAGAACCTGC -> CAGAACCTGCA
TGGTAGAACCT -> GGTAGAACCTA
TGTGAAGCGAT -> GTGAAGCGATA
TATGATCCAGC -> ATGATCCAGCG
CCTCGCCGCGC -> CTCGCCGCGCA
TCTTATTGAGT -> CTTATTGAGTC
GCCGCTCGCTC -> CCGCTCGCTCC
CTTCTCTGGTG -> TTCTCTGGTGC
ATCACGGTGTG -> TCACGGTGTGT
CATTCTTTTGA -> ATTCTTTTGAC
TTAGGGGTCCT -> TAGGGGTCCTT
CGACCAGTGAA -> GACCAGTGAAC
TTTGCCACCCT -> TTGCCACCCTT
ACGATAGCTGA -> CGATAGCTGAA
ACTACAAACGT -> CTACAAACGTC
GCGTCGTGACT -> CGTCGTGACTA
AGTGCTCGAAA -> GTGCTCGAAAG
AACTTAGTATG -> ACTTAGTATGA
TTTGGTGCCTA -> TTGGTGCCTAA
CAAGACGGCAC -> AAGACGGCACT
AAAGGCCATCC -> AAGGCCATCCA
AGAAGAGGGTA -> GAAGAGGGTAG
CAAATCTGCTA -> AAATCTGCTAC
CACCATTTTAC -> ACCATTTTACG
TCGAAAACGTA -> CGAAAACGTAG
ATCCATTGTAG -> TCCATTGTAGT
ACAGATTCGTG -> CAGATTCGTGG
CGTATCCGTTA -> GTATCCGTTAA
TGACTATATGT -> GACTATATGTT
TCCCAATCTAC -> CCCAATCTACT
ACGTAGGTAGA -> CGTAGGTAGAT
GGCCACGAGAT -> GCCACGAGATG
CCATGAGTCAG -> CATGAGTCAGC
GAAAGGACGAC -> AAAGGACGACT
CTCAGAATCCG -> TCAGAATCCGA
TTTTGACTCTC -> TTTGACTCTCA
CCCATCGAACT -> CCATCGAACTT
TACCCATCACG -> ACCCATCACGG
AGTAGAGAAAC -> GTAGAGAAACG
GAAGCCGATCA -> AAGCCGATCAT
GAGTGCTCATA -> AGTGCTCATAC
AATACGTGATT -> ATACGTGATTC
GAACTTAGTAT -> AACTTAGTATG
CAGAATCACAC -> AGAATCACACT
AGCTGAATACA -> GCTGAATACAG
GTTACCCTTCG -> TTACCCTTCGC
GCTCGGGAGGA -> CTCGGGAGGAC
AGTAAGATGTG -> GTAAGATGTGT
ATACCCCATGA -> TACCCCATGAG
TAATAAGTTGG -> AATAAGTTGGC
GGGACGAAAAA -> GGACGAAAAAC
CCCCCTCCCCG -> CCCCTCCCCGG
AGGGGTCCTTC -> GGGGTCCTTCC
GTCCTTCCTGA -> TCCTTCCTGAG
GTGCCGCACCG -> TGCCGCACCGT
ACTATATGTTC -> CTATATGTTCT
GTTGAAATGTG -> TTGAAATGTGG
TGAAGGCAATA -> GAAGGCAATAC
GAGTAGATAGC -> AGTAGATAGCG
GACTACAAACG -> ACTACAAACGT
TTGGGTACTCT -> TGGGTACTCTT
GTGTAAATGCT -> TGTAAATGCTG
GTCTCACGACC -> TCTCACGACCA
TGTCGGTCTTC -> GTCGGTCTTCG
TTCCTATATAT -> TCCTATATATA
ATAGCTCACAC -> TAGCTCACACT
TTGCTAGATCG -> TGCTAGATCGA
ATTCATAATAG -> TTCATAATAGA
CTCTCGAAATC -> TCTCGAAATCA
CTCTTTCCCAC -> TCTTTCCCACG
GTGGATCCTAA -> TGGATCCTAAA
AATCGCCGGAC -> ATCGCCGGACA
CCGATACGCCA -> CGATACGCCAC
GGTTGGTCCCA -> GTTGGTCCCAG
CTTTGAAGTAA -> TTTGAAGTAAC
CCTGTAGATCC -> CTGTAGATCCA
AGTCGAAGAAT -> GTCGAAGAATC
GCCATGGGCCG -> CCATGGGCCGC
CATTCCCCGAA -> ATTCCCCGAAT
GAAGCGATACC -> AAGCGATACCC
AGCCCGGAGTG -> GCCCGGAGTGC
AGCACCGCTTC -> GCACCGCTTCT
TCGTCGCTTCT -> CGTCGCTTCTC
ATCGCCGGACA -> TCGCCGGACAG
TCATAAACGAG -> CATAAACGAGC
ATGTTTCTTGG -> TGTTTCTTGGA
TGACGAAATAC -> GACGAAATACA
TGCTCATACCT -> GCTCATACCTT
CGACTGAGGGA -> GACTGAGGGAC
AATGGCCCCCT -> ATGGCCCCCTA
TCAGAAGCATA -> CAGAAGCATAA
TCCGAAGAAGA -> CCGAAGAAGAG
AGGTCTCACGA -> GGTCTCACGAC
CTGTGAAGCGA -> TGTGAAGCGAT
AAAACTCATTA -> AAACTCATTAG
AACGGAACGTT -> ACGGAACGTTC
CTGCCTGTAGA -> TGCCTGTAGAT
TAAATGCTGGG -> AAATGCTGGGA
AGATGTTTCTT -> GATGTTTCTTG
TAGGTAGATCA -> AGGTAGATCAG
CGTCTGCAGTA -> GTCTGCAGTAT
AAGCCCGGAGT -> AGCCCGGAGTG
CCTTCGCCCTT -> CTTCGCCCTTT
CGTACGATAGC -> GTACGATAGCT
GTAAGTGGATC -> TAAGTGGATCC
TGCCACCCTTT -> GCCACCCTTTT
GTAGATAGCGC -> TAGATAGCGCT
AAATACACTTA -> AATACACTTAG
GGCCTCCCTCG -> GCCTCCCTCGG
TGTTTCGGTTG -> GTTTCGGTTGG
AAGAGGGTAGA -> AGAGGGTAGAA
TCCTGGACGGC -> CCTGGACGGCC
AGTAACAGAAC -> GTAACAGAACC
TGATCCAGCGC -> GATCCAGCGCA
TTCTCAGAATC -> TCTCAGAATCC
GAGGGTAGAAA -> AGGGTAGAAAG
TTAATTCTCAG -> TAATTCTCAGA
AGAAACGGAAT -> GAAACGGAATC
GAGGAAGCCCG -> AGGAAGCCCGG
ATACCTTTGGT -> TACCTTTGGTG
CGTTATGAGGT -> GTTATGAGGTC
ATGCGACCGAA -> TGCGACCGAAG
CGAGCAAGTCT -> GAGCAAGTCTA
ACTGGAGGCAA -> CTGGAGGCAAG
TACCTTTACCT -> ACCTTTACCTT
ACTTCGGAACC -> CTTCGGAACCG
CTCTCACCATT -> TCTCACCATTT
GCCGATCATCA -> CCGATCATCAC
TCTGGCCTTTG -> CTGGCCTTTGA
AAAGATTAGTC -> AAGATTAGTCC
ACGGCAGCTAA -> CGGCAGCTAAT
AAGACACCGCA -> AGACACCGCAC
TGAAGCCGATC -> GAAGCCGATCA
AGGCCTGGTAG -> GGCCTGGTAGA
TGGAGCACCGC -> GGAGCACCGCT
TGCCTAAGAAC -> GCCTAAGAACA
TGTCCCAGAGA -> GTCCCAGAGAC
GCCGCGCAGAT -> CCGCGCAGATC
GAGTATTCGGG -> AGTATTCGGGT
CGAAGGGAGGC -> GAAGGGAGGCC
GAGTTTATGCG -> AGTTTATGCGA
CTCCCACAAGA -> TCCCACAAGAC
CCAGTGCTCGA -> CAGTGCTCGAA
AGTTGAAGCCG -> GTTGAAGCCGA
ACCGGTTTCTG -> CCGGTTTCTGC
CGTGTCCCAGA -> GTGTCCCAGAG
GGTAGAAAGCA -> GTAGAAAGCAT
AACTTATGCCA -> ACTTATGCCAT
ATTCCAATAAG -> TTCCAATAAGC
CATGTCTCCCA -> ATGTCTCCCAC
CAGCTAATCCT -> AGCTAATCCTG
TAGATAGCGCT -> AGATAGCGCTC
CGAGATGTTTC -> GAGATGTTTCT
TGGCCCCCTAG -> GGCCCCCTAGT
CCATCACGGTG -> CATCACGGTGT
AGGTGAAGGCA -> GGTGAAGGCAA
ATTGTAGTCAT -> TTGTAGTCATC
GAACCTATGAT -> AACCTATGATA
TGTCTCCCACA -> GTCTCCCACAA
GTTGCAGCCGT -> TTGCAGCCGTG
ATCTTTTCAAA -> TCTTTTCAAAC
TACGCCACGTT -> ACGCCACGTTA
ATCCGTTAATT -> TCCGTTAATTC
CCATTTTACGG -> CATTTTACGGC
ACAATGGCAGA -> CAATGGCAGAC
CGTCGTGACTA -> GTCGTGACTAT
ACAAGACGGCA -> CAAGACGGCAC
TATGACGAAAT -> ATGACGAAATA
GCCTGAACGGA -> CCTGAACGGAA
GCTGGGACCGT -> CTGGGACCGTA
GGTGGGACGAA -> GTGGGACGAAA
GACGAAATACA -> ACGAAATACAC
CCTTTCGAGCA -> CTTTCGAGCAA
CCACGTTATGA -> CACGTTATGAG
CCTTGCCTAAG -> CTTGCCTAAGA
ACCTGCAGAAA -> CCTGCAGAAAA
GATAGCTGAAT -> ATAGCTGAATA
GCCGCACCGTG -> CCGCACCGTGT
TAGTTCCCATC -> AGTTCCCATCG
CCTAGCTACCA -> CTAGCTACCAG
AAAGGTCTGGC -> AAGGTCTGGCG
CGCGGTCCGGT -> GCGGTCCGGTC
ACCCTTCGCCC -> CCCTTCGCCCT
TGTGGCGAGTA -> GTGGCGAGTAT
AATTCTCCATT -> ATTCTCCATTT
AATGTGGCGAG -> ATGTGGCGAGT
CCCGATACGCC -> CCGATACGCCA
TTCTTGCCAGC -> TCTTGCCAGCA
ACCATTTTACG -> CCATTTTACGG
TATGCCATGGG -> ATGCCATGGGC
TCCCTCGGGTT -> CCCTCGGGTTA
CAATTCTGGCC -> AATTCTGGCCT
GCCGTACGATA -> CCGTACGATAG
AAACGTAGGTA -> AACGTAGGTAG
CTGCAGTATCG -> TGCAGTATCGT
GCCATTGCGAC -> CCATTGCGACT
TAATTTTTGAG -> AATTTTTGAGT
GCCTGGTAGAA -> CCTGGTAGAAC
CGGACTATTTC -> GGACTATTTCC
CAGTGCTCGAA -> AGTGCTCGAAA
GTCCCCGATAC -> TCCCCGATACG
GTATTCGGGTC -> TATTCGGGTCT
GTGCATAGGGC -> TGCATAGGGCC
CGGCAGCTAAT -> GGCAGCTAATC
AGGGAATGGCC -> GGGAATGGCCC
GGAGCACCGCT -> GAGCACCGCTT
ACCGACTCTTA -> CCGACTCTTAT
CATTAGGGGTC -> ATTAGGGGTCC
GCCGGACAGGA -> CCGGACAGGAT
AATCTACTAGC -> ATCTACTAGCG
CTTCGAACAAA -> TTCGAACAAAT
CATAATTCCAA -> ATAATTCCAAT
GGGTCCTTCCT -> GGTCCTTCCTG
AGGGACGAGCG -> GGGACGAGCGA
TAATGCGGTGC -> AATGCGGTGCA
CACCGTGTTGC -> ACCGTGTTGCA
ACATATGATCC -> CATATGATCCA
CGACCGAAGGG -> GACCGAAGGGA
TCTTGCCAGCA -> CTTGCCAGCAA
GGAGTGCCGCA -> GAGTGCCGCAC
AGATACCTTTA -> GATACCTTTAC
ATCAGTAAGTG -> TCAGTAAGTGG
TCCATTTAGGG -> CCATTTAGGGG
AGAGAAAGAGG -> GAGAAAGAGGC
ATCCGAAGAAG -> TCCGAAGAAGA
GGCAAGTTGAA -> GCAAGTTGAAG
AACTCATTAGG -> ACTCATTAGGG
AGTTCCCATCG -> GTTCCCATCGA
GTGCTCATACC -> TGCTCATACCT
TTGCCACCCTT -> TGCCACCCTTT
CATACCTTCTT -> ATACCTTCTTG
TGGGATCAGCC -> GGGATCAGCCT
GAGGTCTCACG -> AGGTCTCACGA
CCATATACGTA -> CATATACGTAT
GATTCCCAATC -> ATTCCCAATCT
TCTGGATAGCT -> CTGGATAGCTC
GTCACGTGACG -> TCACGTGACGC
GACCAGTGAAC -> ACCAGTGAACT
CTGGATAGCTC -> TGGATAGCTCA
AAGCATAAGGT -> AGCATAAGGTG
TCACCATTTTA -> CACCATTTTAC
GATAGCGCTCC -> ATAGCGCTCCC
AAGTAATTTTT -> AGTAATTTTTG
CGAGGGCGAGG -> GAGGGCGAGGC
GCTTGCTAGAT -> CTTGCTAGATC
CGGTCCCCGAT -> GGTCCCCGATA
TCCATACCTTT -> CCATACCTTTG
CACGAGATGTT -> ACGAGATGTTT
TTGCAGCCGTG -> TGCAGCCGTGC
GCCTGAGGAAG -> CCTGAGGAAGC
GTGATGTCACG -> TGATGTCACGT
TCAGAATCCGA -> CAGAATCCGAA
TGAGGCCTCCC -> GAGGCCTCCCG
GCAAGTCTACA -> CAAGTCTACAA
TCATACCTTCT -> CATACCTTCTT
CAAACCACGTC -> AAACCACGTCT
CTCGCCGCGCA -> TCGCCGCGCAG
CTACTAATAAG -> TACTAATAAGT
TCAACATTCTT -> CAACATTCTTT
AAACCACGTCT -> AACCACGTCTG
TAACACATATG -> AACACATATGA
TCGTGGGTGGG -> CGTGGGTGGGA
TTCAGAATCAC -> TCAGAATCACA
TCCCAGTGCTC -> CCCAGTGCTCG
CAGCATACAAA -> AGCATACAAAT
GCACTGTTGCC -> CACTGTTGCCG
GATCAGGGATG -> ATCAGGGATGT
AGACGGCACTG -> GACGGCACTGC
TCATCCTAGCT -> CATCCTAGCTA
TTATCGAAAAC -> TATCGAAAACG
GTAGAACCTAT -> TAGAACCTATG
ATTGAGTCTTG -> TTGAGTCTTGT
TCCATTGTAGT -> CCATTGTAGTC
GGCAATTCTCC -> GCAATTCTCCA
CATACAAATAG -> ATACAAATAGC
CTCCCGGACTA -> TCCCGGACTAT
ATGCGGCGGGA -> TGCGGCGGGAG
CATACCTTTGG -> ATACCTTTGGT
TGCTAGATCGA -> GCTAGATCGAA
AATTCATAATA -> ATTCATAATAG
TCCCACAAGAC -> CCCACAAGACA,CCCACAAGACG
GTTAGCAGCAT -> TTAGCAGCATA
TTAGTCCTTGA -> TAGTCCTTGAT
GGTGCCTAAGA -> GTGCCTAAGAA
CTATCGTCCAT -> TATCGTCCATT
TGCGACTGTTT -> GCGACTGTTTC
GCAGCTAATCC -> CAGCTAATCCT
GTCCGGGTGGC -> TCCGGGTGGCC
GCTACCAGGGG -> CTACCAGGGGA
AGCTTGCTAGA -> GCTTGCTAGAT
AAGATTAGTCC -> AGATTAGTCCT
GGTGAAGGCAA -> GTGAAGGCAAT
ATCCCATATAC -> TCCCATATACG
AGTATGACGAA -> GTATGACGAAA
AGAACAGATTC -> GAACAGATTCG
CTCACACTGTG -> TCACACTGTGA
CCCACAAGACG -> CCACAAGACGG
TCGAAGAATCC -> CGAAGAATCCA
GAAGAATCCAT -> AAGAATCCATT
AGGTTAGCAGC -> GGTTAGCAGCA
CGCGCAGATCC -> GCGCAGATCCC
TTTCTCCTGGA -> TTCTCCTGGAC
CCGAGGTAGTT -> CGAGGTAGTTC
GTATGACGAAA -> TATGACGAAAT
AATACAGGATG -> ATACAGGATGA
TGAACGGAACG -> GAACGGAACGT
GAAAAACTCAT -> AAAAACTCATT
ACTATTTCCGA -> CTATTTCCGAG
GGTGTGTCGTC -> GTGTGTCGTCG
ACGTGATTCCC -> CGTGATTCCCA
GCCTTTGAAGT -> CCTTTGAAGTA
ATGGGCCGCAT -> TGGGCCGCATC
GTCGGTCTTCG -> TCGGTCTTCGA
CAGAGCTTGCT -> AGAGCTTGCTT
CGAGGTAGTTC -> GAGGTAGTTCC
GTTGGTCCCAG -> TTGGTCCCAGT
CTTCGGAACCG -> TTCGGAACCGG
CCCCGATACGC -> CCCGATACGCC
CACTGTCCGGG -> ACTGTCCGGGT
GGTGCGAAGTA -> GTGCGAAGTAA
AGAAAGAGGCT -> GAAAGAGGCTA
TCACGGTGTGT -> CACGGTGTGTC
TCTGAATCGCC -> CTGAATCGCCG
CGATCATCACA -> GATCATCACAT
GAATCATAAAC -> AATCATAAACG
CCAGGGGAGGT -> CAGGGGAGGTT
ATCGTCCATTC -> TCGTCCATTCC
TAGAGTTTATG -> AGAGTTTATGC
ACACACGAAAG -> CACACGAAAGG
GTCAGAAGCAT -> TCAGAAGCATA
TCAGTAAGTGG -> CAGTAAGTGGA
TCCCTAAAGAT -> CCCTAAAGATT
TAATAGAAACA -> AATAGAAACAT
CGCTGCCTGTA -> GCTGCCTGTAG
GCTCGAAAGGT -> CTCGAAAGGTC
AACATATGGAT -> ACATATGGATA
ACAAATAGCGT -> CAAATAGCGTT
TACTAATAAGT -> ACTAATAAGTT
TCGAGCAAGTC -> CGAGCAAGTCT
TGAGGAAGCCC -> GAGGAAGCCCG
TGCCGCACCGT -> GCCGCACCGTG
TCTCCTGGACG -> CTCCTGGACGG
TCCCACGCCGC -> CCCACGCCGCT
CCGGTGTAAAT -> CGGTGTAAATG
AATTATATTTG -> ATTATATTTGC
CGACTTGTACC -> GACTTGTACCT
TTCGAGCAAGT -> TCGAGCAAGTC
GCTGCCTGTAG -> CTGCCTGTAGA
CGATACGCCAC -> GATACGCCACG
GAGGCCTCCCG -> AGGCCTCCCGT
TTCCCACGCCG -> TCCCACGCCGC
TTGCGACTGTT -> TGCGACTGTTT
CACCCTTTTCC -> ACCCTTTTCCC
CAGTAAGATGT -> AGTAAGATGTG
GTGGGTGGGAC -> TGGGTGGGACG
TAGCAGCATAC -> AGCAGCATACA
TGGCCTTTGAA -> GGCCTTTGAAG
AATCACACTAC -> ATCACACTACG
CTAATAAGTTG -> TAATAAGTTGG
AGCTCACACTG -> GCTCACACTGT
GGACAGGATCG -> GACAGGATCGA
GCAGACTACAA -> CAGACTACAAA
CATCACGGTGT -> ATCACGGTGTG
ATATACGTATC -> TATACGTATCC
AGAATCACACT -> GAATCACACTA
CAGCGCAGTAC -> AGCGCAGTACA
CGATAGCTGAA -> GATAGCTGAAT
TTCTAAAGCAG -> TCTAAAGCAGA
TTCCGAGGTAG -> TCCGAGGTAGT
TCAAACCACGT -> CAAACCACGTC
CATATGGATAT -> ATATGGATATT
GCATAATTCCA -> CATAATTCCAA
GGTAGTTCCCA -> GTAGTTCCCAT
CGCTTCTCTGG -> GCTTCTCTGGT
ACGTGTCCCAG -> CGTGTCCCAGA
AAGGGAGGCCA -> AGGGAGGCCAC
AAGGCTCTCGC -> AGGCTCTCGCT
TACGATAGCTG -> ACGATAGCTGA
TACTATGGAGC -> ACTATGGAGCA
AATGATGTTGA -> ATGATGTTGAA
TTCGGGTCTAT -> TCGGGTCTATC
GTACAATTATA -> TACAATTATAT
GCCCGGAGTGC -> CCCGGAGTGCC
AATAGAAACAT -> ATAGAAACATG
ACGCCGCTCGC -> CGCCGCTCGCT
TGGAGGTCTCA -> GGAGGTCTCAC
TGTGTCGTCGC -> GTGTCGTCGCT
GGTTCGACAGA -> GTTCGACAGAG
TGCAGGGAATG -> GCAGGGAATGG
CTGGACGGCCG -> TGGACGGCCGA
AGGCCATCCAA -> GGCCATCCAAT
AGCGATACCCC -> GCGATACCCCA
TCACACTGTGA -> CACACTGTGAA
CGAAAGGACGA -> GAAAGGACGAC
GAGCAAGTCTA -> AGCAAGTCTAC
CTTGCCAGCAA -> TTGCCAGCAAC
AACATGTTCGG -> ACATGTTCGGG
ACATGTCTCCC -> CATGTCTCCCA
AAAGGGGACGG -> AAGGGGACGGT
CCTTTGAAGTA -> CTTTGAAGTAA
CTTCTCTCGAA -> TTCTCTCGAAA
CGCTCGGGAGG -> GCTCGGGAGGA
ATGAGAATGAT -> TGAGAATGATG
CCAATTCGGAG -> CAATTCGGAGT
CTACGTGTCCC -> TACGTGTCCCA
TGTCACGTGAC -> GTCACGTGACG
CTACAATGAAT -> TACAATGAATT
TGGGTGGGACG -> GGGTGGGACGA
AATGCTGGGAC -> ATGCTGGGACC
AGCCGTGCCGT -> GCCGTGCCGTA
CCCCTCCCCGG -> CCCTCCCCGGT
GATGTGTCCCA -> ATGTGTCCCAC
ACTGCGGTTAC -> CTGCGGTTACC
CTTTCCCACGC -> TTTCCCACGCC
AGGGTTTCAGA -> GGGTTTCAGAA
ATATATTCTAA -> TATATTCTAAA
CCGGGTGGCCT -> CGGGTGGCCTC
CGGCCATTGCG -> GGCCATTGCGA
ATTCGGGTCTA -> TTCGGGTCTAT
ACACTTAGGGT -> CACTTAGGGTT
GTGTCCCAGAG -> TGTCCCAGAGA
TTTAAGCGGAG -> TTAAGCGGAGT
GGTCTGGCGTC -> GTCTGGCGTCT
CCATACCTTTG -> CATACCTTTGG
TTCAGGACCTC -> TCAGGACCTCG
AAGGCCATCCA -> AGGCCATCCAA
GGACCTCGCCG -> GACCTCGCCGC
GACTGTTTCCT -> ACTGTTTCCTA
TATACGTATCC -> ATACGTATCCG
GAGGTAGTTCC -> AGGTAGTTCCC
CCACAAGACGG -> CACAAGACGGC
GACAGGTATTA -> ACAGGTATTAA
ATTGGGTACTC -> TTGGGTACTCT
TTCTCGGTTGC -> TCTCGGTTGCA
ATCCTAAATCC -> TCCTAAATCCT
AGGTCTGGCGT -> GGTCTGGCGTC
GCTTGCTTCGA -> CTTGCTTCGAA
ACGTTCTAAGA -> CGTTCTAAGAT
TCCCCGAATTC -> CCCCGAATTCA
GCGCAGATCCC -> CGCAGATCCCT
TGGCGTCTGGG -> GGCGTCTGGGA
GGCAGCTAATC -> GCAGCTAATCC
GGTAGAACCTA -> GTAGAACCTAT
TTATGCGACCG -> TATGCGACCGA
GAGAAAGAGGC -> AGAAAGAGGCT
TATGCGAGAGT -> ATGCGAGAGTG
TCATTAGGGGT -> CATTAGGGGTC
GGGACGAGCGA -> GGACGAGCGAC
CCACGAGATGT -> CACGAGATGTT
ATCGTCCTGTC -> TCGTCCTGTCG
GCGTCTGGGAT -> CGTCTGGGATC
CCCTTTCGAGC -> CCTTTCGAGCA
TAGCTCACACT -> AGCTCACACTG
AGTAGATAGCG -> GTAGATAGCGC
AATTCGGAGTT -> ATTCGGAGTTA
CTTAGTATGAC -> TTAGTATGACG
TCGACAGAGCT -> CGACAGAGCTT
CCCATGAGTCA -> CCATGAGTCAG
TTCTGGATAGC -> TCTGGATAGCT
TGATGTTGAAA -> GATGTTGAAAT
GCTCCCGGACT -> CTCCCGGACTA
CCAGTGAACTG -> CAGTGAACTGG
GCGCTCCCGGA -> CGCTCCCGGAC
CATATGATCCA -> ATATGATCCAG
GCGATACCCCA -> CGATACCCCAT
TGCCTGAACGG -> GCCTGAACGGA
TTGAGTCTTGT -> TGAGTCTTGTC
CCGGACTATTT -> CGGACTATTTC
TGTCCGGGTGG -> GTCCGGGTGGC
CCTCTGACGCG -> CTCTGACGCGA
CGTGATTCCCA -> GTGATTCCCAA
GGATCCTAAAT -> GATCCTAAATC
AGAATCCGAAG -> GAATCCGAAGA
GCTTCGAACTT -> CTTCGAACTTA
TATTGAGTCTT -> ATTGAGTCTTG
TTTCGAGCAAG -> TTCGAGCAAGT
TTTCCGAGGTA -> TTCCGAGGTAG
AAGCGGCAATT -> AGCGGCAATTC
TCTGCAGTATC -> CTGCAGTATCG
GTTTAAGCGGA -> TTTAAGCGGAG
CAGCTTGCTAG -> AGCTTGCTAGA
TAGCGGAGTCG -> AGCGGAGTCGA
AATCATAAACG -> ATCATAAACGA
TAAAGCAGACT -> AAAGCAGACTA
ACCTTTGGTGC -> CCTTTGGTGCC
GTCAGCCCTCC -> TCAGCCCTCCA
GAGTGCCGCAC -> AGTGCCGCACC
TGCGGTGCATA -> GCGGTGCATAG
GCAGCATACAA -> CAGCATACAAA
GGGTAGAAAGC -> GGTAGAAAGCA
CAGCAACATAT -> AGCAACATATG
CGGAACCGGTT -> GGAACCGGTTT
TGGACGGCCGA -> GGACGGCCGAC
ACGCCACGTTA -> CGCCACGTTAT
CCAGAGACCCT -> CAGAGACCCTA
CGAGGCACCAG -> GAGGCACCAGT
ATATATATTCT -> TATATATTCTA
ATCCAGCGCAG -> TCCAGCGCAGT
CGACTCTTATT -> GACTCTTATTG
TTTTACGGCAG -> TTTACGGCAGC
AGCGCAGTACA -> GCGCAGTACAA
ATGGAGCACCG -> TGGAGCACCGC
TTCGTGGGTGG -> TCGTGGGTGGG
TAAATCCTGTT -> AAATCCTGTTT
CGAAAGGTCTG -> GAAAGGTCTGG
CCTCCCCGGTG -> CTCCCCGGTGT
AAACGTCAACA -> AACGTCAACAT
CATAGGGCCTC -> ATAGGGCCTCT
CTACTATGGAG -> TACTATGGAGC
GAGGTTAGCAG -> AGGTTAGCAGC
TCCAGCGCAGT -> CCAGCGCAGTA
ATAGCGCTCCC -> TAGCGCTCCCG
GTTCGGGTTCG -> TTCGGGTTCGA
AGTGCTATGAG -> GTGCTATGAGA
ACGAGCGACTG -> CGAGCGACTGA
GGCACTGCGGT -> GCACTGCGGTT
GGTCTTCGAAC -> GTCTTCGAACA
TACCTTTGAGT -> ACCTTTGAGTA
ACCACGTCTGC -> CCACGTCTGCA
TATTCTAAAGC -> ATTCTAAAGCA
TCAGCCTGAGG -> CAGCCTGAGGA
TTCCCAATCTA -> TCCCAATCTAC
GTTCCCATCGA -> TTCCCATCGAA
GGATGAGTAGA -> GATGAGTAGAG
CGGTGCATAGG -> GGTGCATAGGG
TATATGTTCTG -> ATATGTTCTGG
GAAATCAGTAA -> AAATCAGTAAG
TAAAGATTAGT -> AAAGATTAGTC
CGCCGGACAGG -> GCCGGACAGGA
CTAATCCTGTG -> TAATCCTGTGT
TAATTCCAATA -> AATTCCAATAA
TATGAGGTCGT -> ATGAGGTCGTA
CGGGCGAGTAC -> GGGCGAGTACA
GTCTTCGAACA -> TCTTCGAACAA
CGAAATACACT -> GAAATACACTT
CGCACCGTGTT -> GCACCGTGTTG
ATGAGGTCGTA -> TGAGGTCGTAA
ACCAGGGGAGG -> CCAGGGGAGGT
CCCCATGAGTC -> CCCATGAGTCA
CTCCACCGGGC -> TCCACCGGGCG
GCAGTATCGTC -> CAGTATCGTCC
GCAACATATGG -> CAACATATGGA
AAGAATCCATT -> AGAATCCATTG
GCTACTCGCAT -> CTACTCGCATC
GCCTCTGACGC -> CCTCTGACGCG
CGGGTTCGACA -> GGGTTCGACAG
CGGAGTTATAT -> GGAGTTATATC
GCTCCCAATTC -> CTCCCAATTCG
TCCTGTTTCGG -> CCTGTTTCGGT
GGGAGAGAAAG -> GGAGAGAAAGA
TTGAGTAGATA -> TGAGTAGATAG
CTCCCCGGTGT -> TCCCCGGTGTA
ACAGGATCGAG -> CAGGATCGAGG
TAGGGCCTCTG -> AGGGCCTCTGA
TACCAGGGGAG -> ACCAGGGGAGG
CTGTTTCGGTT -> TGTTTCGGTTG
GTAACAGAACC -> TAACAGAACCT
AAGAGGCTAGG -> AGAGGCTAGGA
CTTCTCGGTTG -> TTCTCGGTTGC
CCTCAGCTTGC -> CTCAGCTTGCT
CTTTTCAAACC -> TTTTCAAACCA
AAATGTGGCGA -> AATGTGGCGAG
CAGCCCTCCAC -> AGCCCTCCACC
ATATTCCTATA -> TATTCCTATAT
CAATGGCAGAC -> AATGGCAGACT
AGCGGAGTCCA -> GCGGAGTCCAA
TGGCATAATTC -> GGCATAATTCC
GCGACTGCCTG -> CGACTGCCTGA
GCTCATACCTT -> CTCATACCTTC
ACAATTATATT -> CAATTATATTT
TTCCCATCGAA -> TCCCATCGAAC
TTTGAGTAGAT -> TTGAGTAGATA
GAATCACACTA -> AATCACACTAC
GTGTTGCATGC -> TGTTGCATGCC
ACGGCACTGCG -> CGGCACTGCGG
GTGCTATGAGA -> TGCTATGAGAA
CGTGCCGTACG -> GTGCCGTACGA
AGAGTGCTCAT -> GAGTGCTCATA
GACGAGCGACT -> ACGAGCGACTG
TGTTTCCTACT -> GTTTCCTACTA
TTTCTTGGAGG -> TTCTTGGAGGT
GTCTACAATGA -> TCTACAATGAA
GATAGCTCACA -> ATAGCTCACAC
CCCAATTCGGA -> CCAATTCGGAG
CTGAGGCCTCC -> TGAGGCCTCCC
TCTCTCGAAAT -> CTCTCGAAATC
GACCCTAGCGG -> ACCCTAGCGGA
CCACCCTTTTC -> CACCCTTTTCC
CAGAGACCCTA -> AGAGACCCTAG
CTATGAGAATG -> TATGAGAATGA
GTTCGACAGAG -> TTCGACAGAGC
CTGTCCGGGTG -> TGTCCGGGTGG
GTAGTTCCCAT -> TAGTTCCCATC