GAACCATAAAAGGAAAACC -> AACCATAAAAGGAAAACCA
AAATAAGACTCGCACTAAC -> AATAAGACTCGCACTAACC
TTCCGGCGGGTATTTCAGA -> TCCGGCGGGTATTTCAGAA
GCGTGTCGTATAGGTACTG -> CGTGTCGTATAGGTACTGC
TTTTTATTCCATAAACAGA -> TTTTATTCCATAAACAGAT
CTATATACGCCGAAATGCC -> TATATACGCCGAAATGCCG
GTATATAAGCGGGTCTAGG -> TATATAAGCGGGTCTAGGA
GGTATTCAGACGTCGTGAG -> GTATTCAGACGTCGTGAGT
GACTTAGTTTGGAACCCAC -> ACTTAGTTTGGAACCCACG
AGGGTATTTAAAGTATGGG -> GGGTATTTAAAGTATGGGA
TGTGAAACCGATTCCCTAG -> GTGAAACCGATTCCCTAGC
GGTGGCCCTCGCAGATGAG -> GTGGCCCTCGCAGATGAGG
CCTTCTGTGCCCCCGTGCA -> CTTCTGTGCCCCCGTGCAC
GTTTAACATACGCCTTGCT -> TTTAACATACGCCTTGCTC
CCAACCTGCAGATGTTGGT -> CAACCTGCAGATGTTGGTA
GCTGTGCTTGACCTTCTGT -> CTGTGCTTGACCTTCTGTG
GCGTTAGCCCTTCAAACCC -> CGTTAGCCCTTCAAACCCT
AAGTGTCAACTGCGCCTCG -> AGTGTCAACTGCGCCTCGA
GAAGTATAGAGCGTTAGCC -> AAGTATAGAGCGTTAGCCC
AGCAAGCATAGCTGTAGTA -> GCAAGCATAGCTGTAGTAA
CTGGTTAGCTAATTGACAT -> TGGTTAGCTAATTGACATT
AAGACGGTGCTTCCTTAGA -> AGACGGTGCTTCCTTAGAG
GAAGTCGCCTGCAGAATAA -> AAGTCGCCTGCAGAATAAT
TGCACGAATCCGAGACTTA -> GCACGAATCCGAGACTTAC
ACTCCCGCATAGACGTTAA -> CTCCCGCATAGACGTTAAC
GGTAGAAGTCGCCTGCAGA -> GTAGAAGTCGCCTGCAGAA
ACAATAGTTAGAATAATGT -> CAATAGTTAGAATAATGTA
TAGAGGTATTCAGAAAAGC -> AGAGGTATTCAGAAAAGCG
ATCAGATGCACGTGACAAA -> TCAGATGCACGTGACAAAC
TGCCAGTTTGTCACATTGG -> GCCAGTTTGTCACATTGGC
GCCTAACAGTTCTGGTTAG -> CCTAACAGTTCTGGTTAGC
ACATTTGCCTTGAAAAATA -> CATTTGCCTTGAAAAATAA
CTCGATAATGTTTCTTTCG -> TCGATAATGTTTCTTTCGA
AGGAGCACTGTTCCCTTCG -> GGAGCACTGTTCCCTTCGA
ATGTAGCGTGTAGCAGACT -> TGTAGCGTGTAGCAGACTT
GATGAGACGTTCTTTTTAT -> ATGAGACGTTCTTTTTATT
TTCAGAATAAACCATTTTG -> TCAGAATAAACCATTTTGA
TTTGGATGCCTGCCTCTGC -> TTGGATGCCTGCCTCTGCC
CTTAATTTTCTGTACCAAC -> TTAATTTTCTGTACCAACA
CATGACCTGCGGGCTCACA -> ATGACCTGCGGGCTCACAC
CCCCAGCCGGAGGTGGTAC -> CCCAGCCGGAGGTGGTACC
ATGAAGTATAGAGCGTTAG -> TGAAGTATAGAGCGTTAGC
GTCCTTAGTTGTCGATGTG -> TCCTTAGTTGTCGATGTGA
GATGCCTGCCTCTGCCACC -> ATGCCTGCCTCTGCCACCC
AATAGAAGCCAAAACAGGT -> ATAGAAGCCAAAACAGGTT
CTTGAAAAATAAGACTCGC -> TTGAAAAATAAGACTCGCA
CCGCATCTTTTTTATGCGG -> CGCATCTTTTTTATGCGGT
ATTATTGTTCCGTTTTCAA -> TTATTGTTCCGTTTTCAAG
TGCATTTTGGATGCCTGCC -> GCATTTTGGATGCCTGCCT
TTGTCAGAAATAGAAGCCA -> TGTCAGAAATAGAAGCCAA
ATTCCCTAGCATCCGAGGC -> TTCCCTAGCATCCGAGGCA
CAACTGCGCCTCGATAATG -> AACTGCGCCTCGATAATGT
GAGTTTCGTCAACTGAGGT -> AGTTTCGTCAACTGAGGTT
CAGTACAATTTTTAGCCCA -> AGTACAATTTTTAGCCCAT
AGGTTTTGTAATTAACACC -> GGTTTTGTAATTAACACCA
ACACCATTCGATTGGACGG -> CACCATTCGATTGGACGGA
GTCCTTAGAGGTATTCAGA -> TCCTTAGAGGTATTCAGAG
TAGGCGATGTGACTCTTCT -> AGGCGATGTGACTCTTCTC
TAGGGCGCTAGTCTACGCT -> AGGGCGCTAGTCTACGCTG
TTGGGTGCATTTTGGATGC -> TGGGTGCATTTTGGATGCC
ATTCAGACGTCGTGAGTCG -> TTCAGACGTCGTGAGTCGC
GGTTAAGTGTCAACTGCGC -> GTTAAGTGTCAACTGCGCC
ACGTTCTTTTTATTCCATA -> CGTTCTTTTTATTCCATAA
ACGCCGAAATGCCGCACCA -> CGCCGAAATGCCGCACCAG
CTCGAGGATGCGCGTGACG -> TCGAGGATGCGCGTGACGC
AAACCGCGAGGAAAATGTT -> AACCGCGAGGAAAATGTTA
GGGTATTTCAGAATAAACC -> GGTATTTCAGAATAAACCA
CCTTCAAACCCTTAATTTT -> CTTCAAACCCTTAATTTTC
ACCGCAACTGCGGTGAGTT -> CCGCAACTGCGGTGAGTTT
AAATAGAAGCCAAAACAGG -> AATAGAAGCCAAAACAGGT
GTGACTCTTCTCCTTGCAT -> TGACTCTTCTCCTTGCATA
TCATATCGTACGCTGTACT -> CATATCGTACGCTGTACTC
GAATAATGTAGCGTGTAGC -> AATAATGTAGCGTGTAGCA
TAGAGTTATTGTCGTTAGT -> AGAGTTATTGTCGTTAGTT
GACTTAGGCGATGTGACTC -> ACTTAGGCGATGTGACTCT
ATTTTTAGCCCATTATTGT -> TTTTTAGCCCATTATTGTT
GCGTTAAGACAAACCGCAG -> CGTTAAGACAAACCGCAGC
GGAGGTGGTACCTCACTGT -> GAGGTGGTACCTCACTGTA
GTGACAAACAGGTTGGGGG -> TGACAAACAGGTTGGGGGC
TTCGACAGATTCGACCGCA -> TCGACAGATTCGACCGCAT
TTCCGGCCTGGGCGCAGCT -> TCCGGCCTGGGCGCAGCTA
GACAAACAGGTTGGGGGCC -> ACAAACAGGTTGGGGGCCG
TAACCCTCCAGTATTGTCA -> AACCCTCCAGTATTGTCAG
GTTCCGGTTGGGTGCCCCG -> TTCCGGTTGGGTGCCCCGA
CGTGACAAACAGGTTGGGG -> GTGACAAACAGGTTGGGGG
TCACACGTTCGAGATGCAC -> CACACGTTCGAGATGCACT
CCACTCCGGGCTGTGCGAC -> CACTCCGGGCTGTGCGACT
CTAGTCTACGCTGTTAACA -> TAGTCTACGCTGTTAACAC
CTAACCCCCAGCCGGAGGT -> TAACCCCCAGCCGGAGGTG
CATTCGACATCGTCTTACA -> ATTCGACATCGTCTTACAT
GGGAACTGTACTATCTGAA -> GGAACTGTACTATCTGAAC
TACAATAGTTAGAATAATG -> ACAATAGTTAGAATAATGT
TGTACGTGGTCCTTAGAGG -> GTACGTGGTCCTTAGAGGT
GACGCCCTATCAAATACTG -> ACGCCCTATCAAATACTGA
GAGCGACCGGTGGCCCTCG -> AGCGACCGGTGGCCCTCGC
TGTGATGAGACGTTCTTTT -> GTGATGAGACGTTCTTTTT
TATCGTAAAGTGGCCCGTG -> ATCGTAAAGTGGCCCGTGC
AGCGTTAGCCCTTCAAACC -> GCGTTAGCCCTTCAAACCC
ACCGTGTGAAACCGATTCC -> CCGTGTGAAACCGATTCCC
GTAAAAGTTTAAGCATGAA -> TAAAAGTTTAAGCATGAAG
CCGTGTGAAACCGATTCCC -> CGTGTGAAACCGATTCCCT
GCAGCTAAGGTCCTCAGTA -> CAGCTAAGGTCCTCAGTAC
ACTAACCCCCAGCCGGAGG -> CTAACCCCCAGCCGGAGGT
TTCCCTAGCATCCGAGGCA -> TCCCTAGCATCCGAGGCAT
GAACATAGACTATATCCGT -> AACATAGACTATATCCGTG
AATCATGTCCTTAGTTGTC -> ATCATGTCCTTAGTTGTCG
AAAACCAACACTAACCCTC -> AAACCAACACTAACCCTCC
TCTGGTTAGCTAATTGACA -> CTGGTTAGCTAATTGACAT
TTCTGGTTAGCTAATTGAC -> TCTGGTTAGCTAATTGACA
AACCCCCAGCCGGAGGTGG -> ACCCCCAGCCGGAGGTGGT
AAGCATAGCTGTAGTAAGC -> AGCATAGCTGTAGTAAGCT
TCCGAGGCATCCTTAGAGG -> CCGAGGCATCCTTAGAGGT
CCCTCTATGTAAACCGACT -> CCTCTATGTAAACCGACTC
CATATCGTAAAGTGGCCCG -> ATATCGTAAAGTGGCCCGT
GTTCCCTTCGACGGTGTGT -> TTCCCTTCGACGGTGTGTA
CGCATCATAGAGTTATTGT -> GCATCATAGAGTTATTGTC
CGCCGAGTGGCGATCGGTG -> GCCGAGTGGCGATCGGTGG
GAGAGACAATTCTTTCCTC -> AGAGACAATTCTTTCCTCC
ATATGGGCCTAACAGTTCT -> TATGGGCCTAACAGTTCTG
CGAGACTTACTCGAGGTAG -> GAGACTTACTCGAGGTAGG
GCCGTTTCAGTGCAAGGTA -> CCGTTTCAGTGCAAGGTAA
CCCCCAGCCGGAGGTGGTA -> CCCCAGCCGGAGGTGGTAC
GCCTGCCTCTGCCACCCGG -> CCTGCCTCTGCCACCCGGC
TGATGAGACGTTCTTTTTA -> GATGAGACGTTCTTTTTAT
GTCAACGTGCCCTCTATGT -> TCAACGTGCCCTCTATGTA
GCAAGGTAATAAGTGCCAG -> CAAGGTAATAAGTGCCAGT
GTTCGAGATGCACTAGCCC -> TTCGAGATGCACTAGCCCA
AGCGTGGAATGTAATATAC -> GCGTGGAATGTAATATACA
CCAAATTGTTCGCAAGACG -> CAAATTGTTCGCAAGACGG
ACTCTTCTCCTTGCATAGG -> CTCTTCTCCTTGCATAGGC
ATATCCGTGCGCCGAGTGG -> TATCCGTGCGCCGAGTGGC
TTTTATGCGGTAACTGCGC -> TTTATGCGGTAACTGCGCA
CGCAGCTAAGGTCCTCAGT -> GCAGCTAAGGTCCTCAGTA
TGCGGAAAAAAACCTCAAC -> GCGGAAAAAAACCTCAACT
GACCTGCGGGCTCACACGT -> ACCTGCGGGCTCACACGTT
CGTGCCCTCTATGTAAACC -> GTGCCCTCTATGTAAACCG
ACGTGCCCTCTATGTAAAC -> CGTGCCCTCTATGTAAACC
ATAGTAGTTCCGGTTGGGT -> TAGTAGTTCCGGTTGGGTG
TCAGCTGCCGAAACGAATG -> CAGCTGCCGAAACGAATGT
ACACGCAGAACGCAGCAAC -> CACGCAGAACGCAGCAACA
CGTCTTACATATCGTAAAG -> GTCTTACATATCGTAAAGT
CCTAACAGTTCTGGTTAGC -> CTAACAGTTCTGGTTAGCT
ACCATTTTGATGAATTACA -> CCATTTTGATGAATTACAT
ATAATGGGGAGTTTGGACT -> TAATGGGGAGTTTGGACTA
GACATACATGAGCCGTTTC -> ACATACATGAGCCGTTTCA
GAGGTATTCAGAAAAGCGG -> AGGTATTCAGAAAAGCGGC
TAACACTTAGGAATGTCCC -> AACACTTAGGAATGTCCCG
TTGCATAGGCGTAGGTGAG -> TGCATAGGCGTAGGTGAGG
AAAACAGGTTGCGGAAAAA -> AAACAGGTTGCGGAAAAAA
CACGCCGCAGTTTAGAACT -> ACGCCGCAGTTTAGAACTG
TAACACCATTCGATTGGAC -> AACACCATTCGATTGGACG
TGAATGTGCCCTGGCTTTT -> GAATGTGCCCTGGCTTTTC
TCGCAAGACGGTGCTTCCT -> CGCAAGACGGTGCTTCCTT
CGAGAGTGCACCTCCAACC -> GAGAGTGCACCTCCAACCT
TGTAATTAACACCATTCGA -> GTAATTAACACCATTCGAT
TAGTCTACGCTGTTAACAC -> AGTCTACGCTGTTAACACT
ATGAGCCGTTTCAGTGCAA -> TGAGCCGTTTCAGTGCAAG
ACAGGTTGCGGAAAAAAAC -> CAGGTTGCGGAAAAAAACC
GCCTGCAGAATAATGGGGA -> CCTGCAGAATAATGGGGAG
ATTCAGAAAAGCGGCCCAG -> TTCAGAAAAGCGGCCCAGC
AGACGTCGTGAGTCGCCCT -> GACGTCGTGAGTCGCCCTA
GATTGGACGGAACTAAAAC -> ATTGGACGGAACTAAAACC
GGTACTGCAGTGTCGGTCT -> GTACTGCAGTGTCGGTCTC
CTAACCCTCCAGTATTGTC -> TAACCCTCCAGTATTGTCA
ATCGTACGCTGTACTCGTG -> TCGTACGCTGTACTCGTGT
CTGTTAACACTTAGGAATG -> TGTTAACACTTAGGAATGT
TGTAGCGTGTAGCAGACTT -> GTAGCGTGTAGCAGACTTA
AACATAACCGGTCAACGTG -> ACATAACCGGTCAACGTGC
AGGTACTGCAGTGTCGGTC -> GGTACTGCAGTGTCGGTCT
TGGAACCCACGCCGCAGTT -> GGAACCCACGCCGCAGTTT
ACATCGTTTAACATACGCC -> CATCGTTTAACATACGCCT
AAATGCCGCACCAGAACCA -> AATGCCGCACCAGAACCAT
GAGCCCTAATAGTAGTTCC -> AGCCCTAATAGTAGTTCCG
TAAATCATGTCCTTAGTTG -> AAATCATGTCCTTAGTTGT
TCTTTTTTATGCGGTAACT -> CTTTTTTATGCGGTAACTG
ACTGTTCCCTTCGACGGTG -> CTGTTCCCTTCGACGGTGT
TAATGTAGCGTGTAGCAGA -> AATGTAGCGTGTAGCAGAC
AGATGCACGTGACAAACAG -> GATGCACGTGACAAACAGG
GCTGGTGAACATAGACTAT -> CTGGTGAACATAGACTATA
ACTACTACACCGGCAATCA -> CTACTACACCGGCAATCAT
GCCCTTCAAACCCTTAATT -> CCCTTCAAACCCTTAATTT
CCCTAATAGTAGTTCCGGT -> CCTAATAGTAGTTCCGGTT,CCTAATAGTAGTTCCGGTT
AACCCTTAATTTTCTGTAC -> ACCCTTAATTTTCTGTACC
GGGACTGCTAGGTTTTGTA -> GGACTGCTAGGTTTTGTAA
CCGCGAGGAAAATGTTAAA -> CGCGAGGAAAATGTTAAAT
GTCGCCCTAATAGTAGTTC -> TCGCCCTAATAGTAGTTCC
AACTAGACTTACAGCCTCT -> ACTAGACTTACAGCCTCTT
TCCGGTTTCACAGGGGCCC -> CCGGTTTCACAGGGGCCCC
TTCTGTGCCCCCGTGCACG -> TCTGTGCCCCCGTGCACGA
GTGCTTCCTTAGAGGTATT -> TGCTTCCTTAGAGGTATTC
AAAAACCTCAACTACCGCA -> AAAACCTCAACTACCGCAA
ATGAGACGTTCTTTTTATT -> TGAGACGTTCTTTTTATTC
GTAGCGTGTAGCAGACTTA -> TAGCGTGTAGCAGACTTAT
TAAAACCGCGAGGAAAATG -> AAAACCGCGAGGAAAATGT
TGTATAGTCATTCGACATC -> GTATAGTCATTCGACATCG
TGCCGAAACGAATGTGATA -> GCCGAAACGAATGTGATAC
GGTTGGGTGCCCCGAGCGA -> GTTGGGTGCCCCGAGCGAC
CACTATGATTCCAAATTGT -> ACTATGATTCCAAATTGTT
TAGTAAGCTATGACACGCA -> AGTAAGCTATGACACGCAG
AACCATGTCTATCATAGCT -> ACCATGTCTATCATAGCTA
TCTTACATATCGTAAAGTG -> CTTACATATCGTAAAGTGG
AACGTGCCCTCTATGTAAA -> ACGTGCCCTCTATGTAAAC
CTAGCATCCGAGGCATCCT -> TAGCATCCGAGGCATCCTT
AGACATACATGAGCCGTTT -> GACATACATGAGCCGTTTC
ACAACAGTTAGCGGAAGCG -> CAACAGTTAGCGGAAGCGT
CATTATTCGCTGGTGAACA -> ATTATTCGCTGGTGAACAT
GCCCGTGCGTGTCGTATAG -> CCCGTGCGTGTCGTATAGG
AACAGTTAGCGGAAGCGTG -> ACAGTTAGCGGAAGCGTGG
CAACCACTCCGGGCTGTGC -> AACCACTCCGGGCTGTGCG
TACTGCAGTGTCGGTCTCG -> ACTGCAGTGTCGGTCTCGA
TACGCAATGCGTATTCATA -> ACGCAATGCGTATTCATAT
TGGCGATAAACAGGTTAAA -> GGCGATAAACAGGTTAAAG
GCAGCAACATAACCGGTCA -> CAGCAACATAACCGGTCAA
TTAGAACTGATGTATAGTC -> TAGAACTGATGTATAGTCA
AGTCGCCCTAATAGTAGTT -> GTCGCCCTAATAGTAGTTC
ACAATTCTTTCCTCCTTAG -> CAATTCTTTCCTCCTTAGA
AACATAGACTATATCCGTG -> ACATAGACTATATCCGTGC
GCGGTGAGTTTCGTCAACT -> CGGTGAGTTTCGTCAACTG
CTCTTCTCCTTGCATAGGC -> TCTTCTCCTTGCATAGGCG
CGGTCAACGTGCCCTCTAT -> GGTCAACGTGCCCTCTATG
CCGTTTCAGTGCAAGGTAA -> CGTTTCAGTGCAAGGTAAT
TATCAAATACTGAGGGTAT -> ATCAAATACTGAGGGTATT
CTCTCAGCTGCCGAAACGA -> TCTCAGCTGCCGAAACGAA
AACTTCACTGTCAGTCGAG -> ACTTCACTGTCAGTCGAGT
AATTTATATGCGAGAGACA -> ATTTATATGCGAGAGACAA
GGCGGGTATTTCAGAATAA -> GCGGGTATTTCAGAATAAA
GTGCCCTCTATGTAAACCG -> TGCCCTCTATGTAAACCGA
ATGTTTCTTTCGACTACTA -> TGTTTCTTTCGACTACTAC
GATAATGTTTCTTTCGACT -> ATAATGTTTCTTTCGACTA
CATTTTGATGAATTACATC -> ATTTTGATGAATTACATCG
TTGCGGAAAAAAACCTCAA -> TGCGGAAAAAAACCTCAAC
ACTGCTAGGTTTTGTAATT -> CTGCTAGGTTTTGTAATTA
TGGTTAGCTAATTGACATT -> GGTTAGCTAATTGACATTT
TGGGCGCAGCTAAGGTCCT -> GGGCGCAGCTAAGGTCCTC
CGGAACTAAAACCGCGAGG -> GGAACTAAAACCGCGAGGA
CTGAGGTTGGCGATAAACA -> TGAGGTTGGCGATAAACAG
GATGTGACTCTTCTCCTTG -> ATGTGACTCTTCTCCTTGC
GCGATCGGTGGAGGAGCAC -> CGATCGGTGGAGGAGCACT
AAACCGACTCCCGCATAGA -> AACCGACTCCCGCATAGAC
ACCCTTAATTTTCTGTACC -> CCCTTAATTTTCTGTACCA
AGATGGGGGTGCGAGCCCT -> GATGGGGGTGCGAGCCCTA
GTAATATACAGAGGTTAAG -> TAATATACAGAGGTTAAGT
TGAGTTTCGTCAACTGAGG -> GAGTTTCGTCAACTGAGGT
CTGTGCTTGACCTTCTGTG -> TGTGCTTGACCTTCTGTGC
TAAAGTATGGGACCGCTCT -> AAAGTATGGGACCGCTCTC
ACTGCGCAGCAACCACTCC -> CTGCGCAGCAACCACTCCG
ACGGAACTAAAACCGCGAG -> CGGAACTAAAACCGCGAGG
GTTAACAATTTATATGCGA -> TTAACAATTTATATGCGAG
ACATAGACTATATCCGTGC -> CATAGACTATATCCGTGCG
CTCGCAGATGAGGTGCCGG -> TCGCAGATGAGGTGCCGGA
ACCTCACTGTAACCATGTC -> CCTCACTGTAACCATGTCT
TCTGTACCAACAACAGTTA -> CTGTACCAACAACAGTTAG
GAATTACATCGTTTAACAT -> AATTACATCGTTTAACATA
AGTTCCGGTTTCACAGGGG -> GTTCCGGTTTCACAGGGGC
GCCAAAACAGGTTGCGGAA -> CCAAAACAGGTTGCGGAAA
CAGCAACATAACCGGTCAA -> AGCAACATAACCGGTCAAC
GGTATTCAGATGGGGGTGC -> GTATTCAGATGGGGGTGCG
AGAATAAACCATTTTGATG -> GAATAAACCATTTTGATGA
ACCATAAAAGGAAAACCAA -> CCATAAAAGGAAAACCAAC
CTTAGGAATGTCCCGTTCT -> TTAGGAATGTCCCGTTCTC
CCTATCAAATACTGAGGGT -> CTATCAAATACTGAGGGTA
GGAACAGACATACATGAGC -> GAACAGACATACATGAGCC
CCTGGGCGCAGCTAAGGTC -> CTGGGCGCAGCTAAGGTCC
ATTCATATCGTACGCTGTA -> TTCATATCGTACGCTGTAC
TCCCTAGCATCCGAGGCAT -> CCCTAGCATCCGAGGCATC
GTAGCAGACTTATTTCGAC -> TAGCAGACTTATTTCGACA
GACGTTAACAATTTATATG -> ACGTTAACAATTTATATGC
CATTTTGGATGCCTGCCTC -> ATTTTGGATGCCTGCCTCT
GCAACATGACCTGCGGGCT -> CAACATGACCTGCGGGCTC
TCCGGTTGGGTGCCCCGAG -> CCGGTTGGGTGCCCCGAGC
GGGTGCATTTTGGATGCCT -> GGTGCATTTTGGATGCCTG
ACAAACCGCAGCATACGCA -> CAAACCGCAGCATACGCAA
CGCATCTTTTTTATGCGGT -> GCATCTTTTTTATGCGGTA
CTGGGACTGCTAGGTTTTG -> TGGGACTGCTAGGTTTTGT
CGACCGGTGGCCCTCGCAG -> GACCGGTGGCCCTCGCAGA
CCTTGAAAAATAAGACTCG -> CTTGAAAAATAAGACTCGC
CTGCTAGGTTTTGTAATTA -> TGCTAGGTTTTGTAATTAA
AGGGGCCCCCGGATGATAT -> GGGGCCCCCGGATGATATG
TTGGGTGCCCCGAGCGACC -> TGGGTGCCCCGAGCGACCG
TGATGTATAGTCATTCGAC -> GATGTATAGTCATTCGACA
TTACATCGTTTAACATACG -> TACATCGTTTAACATACGC
TGCCCTGGCTTTTCTCGAT -> GCCCTGGCTTTTCTCGATC
GCTCACACGTTCGAGATGC -> CTCACACGTTCGAGATGCA
AACCGCAGCATACGCAATG -> ACCGCAGCATACGCAATGC
ATTATTCGCTGGTGAACAT -> TTATTCGCTGGTGAACATA
TTACATATCGTAAAGTGGC -> TACATATCGTAAAGTGGCC
CTTACTCGAGGTAGGGCGC -> TTACTCGAGGTAGGGCGCT
GCGTGTAGCAGACTTATTT -> CGTGTAGCAGACTTATTTC
GTGGTTAAACTAGACTTAC -> TGGTTAAACTAGACTTACA
CGGGTATTTCAGAATAAAC -> GGGTATTTCAGAATAAACC
CCTAATAGTAGTTCCGGTT -> CTAATAGTAGTTCCGGTTT,CTAATAGTAGTTCCGGTTG
TTCAGAGAAACTTAGACGC -> TCAGAGAAACTTAGACGCC
TATTGTCAGAAATAGAAGC -> ATTGTCAGAAATAGAAGCC
CATGTCCTTAGTTGTCGAT -> ATGTCCTTAGTTGTCGATG
GCCCATTATTGTTCCGTTT -> CCCATTATTGTTCCGTTTT
GGAGGGATACTGGTGCCTC -> GAGGGATACTGGTGCCTCT
TATAGTCATTCGACATCGT -> ATAGTCATTCGACATCGTC
CAGCCTCTTGCAATCCACT -> AGCCTCTTGCAATCCACTT
GAGCACTGTTCCCTTCGAC -> AGCACTGTTCCCTTCGACG
GACACGCAGAACGCAGCAA -> ACACGCAGAACGCAGCAAC
TATATCCGTGCGCCGAGTG -> ATATCCGTGCGCCGAGTGG
CGTGTGAAACCGATTCCCT -> GTGTGAAACCGATTCCCTA
TGGGCCTAACAGTTCTGGT -> GGGCCTAACAGTTCTGGTT
TGCACCTCCAACCTGCAGA -> GCACCTCCAACCTGCAGAT
CTCAGTACAATTTTTAGCC -> TCAGTACAATTTTTAGCCC
TCCAAATTGTTCGCAAGAC -> CCAAATTGTTCGCAAGACG
CTACACCGGCAATCATCCG -> TACACCGGCAATCATCCGC
GGTAGGTACGGCCTGGGAC -> GTAGGTACGGCCTGGGACT
TTTAGAACTGATGTATAGT -> TTAGAACTGATGTATAGTC
CAGTCGAGTGGTTAAACTA -> AGTCGAGTGGTTAAACTAG
TTGGCGATAAACAGGTTAA -> TGGCGATAAACAGGTTAAA
TAAACCGACTCCCGCATAG -> AAACCGACTCCCGCATAGA
AACAGGTTGCGGAAAAAAA -> ACAGGTTGCGGAAAAAAAC
ACGTGACAAACAGGTTGGG -> CGTGACAAACAGGTTGGGG
ACTGCGCCTCGATAATGTT -> CTGCGCCTCGATAATGTTT
TTTAACATACGCCTTGCTC -> TTAACATACGCCTTGCTCG
AAGGTCCTCAGTACAATTT -> AGGTCCTCAGTACAATTTT
GCACTAGCCCAGCGTTAAG -> CACTAGCCCAGCGTTAAGA
CCTTAATTTTCTGTACCAA -> CTTAATTTTCTGTACCAAC
GTGCCCCGAGCGACCGGTG -> TGCCCCGAGCGACCGGTGG
CTTAGAGGTATTCAGAGAA -> TTAGAGGTATTCAGAGAAA
CGTATAGGTACTGCAGTGT -> GTATAGGTACTGCAGTGTC
TATTGGATATACTTGGGTG -> ATTGGATATACTTGGGTGC
TAGGAATGTCCCGTTCTCA -> AGGAATGTCCCGTTCTCAT
TCGATTGGACGGAACTAAA -> CGATTGGACGGAACTAAAA
GTGGTACCTCACTGTAACC -> TGGTACCTCACTGTAACCA
ACGTTCGAGATGCACTAGC -> CGTTCGAGATGCACTAGCC
TCCATAAACAGATTTACAG -> CCATAAACAGATTTACAGC
AGCATAGCTGTAGTAAGCT -> GCATAGCTGTAGTAAGCTA
GCCTGGGACTGCTAGGTTT -> CCTGGGACTGCTAGGTTTT
CGGTGAGTTTCGTCAACTG -> GGTGAGTTTCGTCAACTGA
TTCCCTTCGACGGTGTGTA -> TCCCTTCGACGGTGTGTAT
GGATGCGCGTGACGCCCTA -> GATGCGCGTGACGCCCTAT
ACAGCCTCTTGCAATCCAC -> CAGCCTCTTGCAATCCACT
GTATTCAGAGAAACTTAGA -> TATTCAGAGAAACTTAGAC
GAGACGTTCTTTTTATTCC -> AGACGTTCTTTTTATTCCA
CTGCGGGCTCACACGTTCG -> TGCGGGCTCACACGTTCGA
GGTAATAAGTGCCAGTTTG -> GTAATAAGTGCCAGTTTGT
TGTTGGTAGAAGTCGCCTG -> GTTGGTAGAAGTCGCCTGC
AGATTCGACCGCATCTTTT -> GATTCGACCGCATCTTTTT
CTTCTGTGCCCCCGTGCAC -> TTCTGTGCCCCCGTGCACG
TCCTTGCATAGGCGTAGGT -> CCTTGCATAGGCGTAGGTG
ACATACGCCTTGCTCGGGA -> CATACGCCTTGCTCGGGAC
AATGTGATACGCCTGCCCA -> ATGTGATACGCCTGCCCAA
ACAGACATACATGAGCCGT -> CAGACATACATGAGCCGTT
GATGTATAGTCATTCGACA -> ATGTATAGTCATTCGACAT
CAACAACAGTTAGCGGAAG -> AACAACAGTTAGCGGAAGC
GTCAGTCGAGTGGTTAAAC -> TCAGTCGAGTGGTTAAACT
GATCGGTGGAGGAGCACTG -> ATCGGTGGAGGAGCACTGT
ACACGTTCGAGATGCACTA -> CACGTTCGAGATGCACTAG
ATTCGCTGGTGAACATAGA -> TTCGCTGGTGAACATAGAC
GTGAGGCACACAGGTTATC -> TGAGGCACACAGGTTATCA
GCGAGAGTGCACCTCCAAC -> CGAGAGTGCACCTCCAACC
ACGAATGTGATACGCCTGC -> CGAATGTGATACGCCTGCC
ACATGACCTGCGGGCTCAC -> CATGACCTGCGGGCTCACA
GGATGCGAGAGTGCACCTC -> GATGCGAGAGTGCACCTCC
GTAGCAAGCATAGCTGTAG -> TAGCAAGCATAGCTGTAGT
CACCAGAACCATAAAAGGA -> ACCAGAACCATAAAAGGAA
GAGATCACTGGGAACTGTA -> AGATCACTGGGAACTGTAC
AATCATCCGCCGCATCATA -> ATCATCCGCCGCATCATAG
CCGAGTGGCGATCGGTGGA -> CGAGTGGCGATCGGTGGAG
GCACTATGATTCCAAATTG -> CACTATGATTCCAAATTGT
CGAGGATGCGCGTGACGCC -> GAGGATGCGCGTGACGCCC
GAGTCGCCCTAATAGTAGT -> AGTCGCCCTAATAGTAGTT
TTTATTGGATATACTTGGG -> TTATTGGATATACTTGGGT
CTAGCCCAGCGTTAAGACA -> TAGCCCAGCGTTAAGACAA
CCATAAAAGGAAAACCAAC -> CATAAAAGGAAAACCAACA
GCATAGCTGTAGTAAGCTA -> CATAGCTGTAGTAAGCTAT
TCGTGTCGCGCTTGTACGT -> CGTGTCGCGCTTGTACGTG
CGGTAACTGCGCAGCAACC -> GGTAACTGCGCAGCAACCA
CGCAAGACGGTGCTTCCTT -> GCAAGACGGTGCTTCCTTA
AACAGGTTGGGGGCCGTAG -> ACAGGTTGGGGGCCGTAGC
ATGTGATGAGACGTTCTTT -> TGTGATGAGACGTTCTTTT
CGAATCCGAGACTTACTCG -> GAATCCGAGACTTACTCGA
GCCTTGCTCGGGACTTAGT -> CCTTGCTCGGGACTTAGTT
CTACCGCAACTGCGGTGAG -> TACCGCAACTGCGGTGAGT
TGGTACCTCACTGTAACCA -> GGTACCTCACTGTAACCAT
CATGAGCCGTTTCAGTGCA -> ATGAGCCGTTTCAGTGCAA
CTTTTCTCGATCAGATGCA -> TTTTCTCGATCAGATGCAC
ATTCAGATGGGGGTGCGAG -> TTCAGATGGGGGTGCGAGC
GCGCGTGACGCCCTATCAA -> CGCGTGACGCCCTATCAAA
CTAATAGTAGTTCCGGCCT -> TAATAGTAGTTCCGGCCTG
GAAAAATAAGACTCGCACT -> AAAAATAAGACTCGCACTA
GATCACTGGGAACTGTACT -> ATCACTGGGAACTGTACTA
TCGGGACTTAGTTTGGAAC -> CGGGACTTAGTTTGGAACC
TTTCCTCCTTAGAGGTATT -> TTCCTCCTTAGAGGTATTC
TTGTCGATGTGATGAGACG -> TGTCGATGTGATGAGACGT
AGTATAGAGCGTTAGCCCT -> GTATAGAGCGTTAGCCCTT
GACTCTTCTCCTTGCATAG -> ACTCTTCTCCTTGCATAGG
ACGCCCTATCAAATACTGA -> CGCCCTATCAAATACTGAG
GATGCACGTGACAAACAGG -> ATGCACGTGACAAACAGGT
GGGACTTAGTTTGGAACCC -> GGACTTAGTTTGGAACCCA
AACACTAACCCTCCAGTAT -> ACACTAACCCTCCAGTATT
CTAAGGTCCTCAGTACAAT -> TAAGGTCCTCAGTACAATT
CGTGCGTGTCGTATAGGTA -> GTGCGTGTCGTATAGGTAC
TTCATATCGTACGCTGTAC -> TCATATCGTACGCTGTACT
TACAATTTTTAGCCCATTA -> ACAATTTTTAGCCCATTAT
ATAGCTGTAGTAAGCTATG -> TAGCTGTAGTAAGCTATGA
CGAGTGGTTAAACTAGACT -> GAGTGGTTAAACTAGACTT
CGGCCTGGGACTGCTAGGT -> GGCCTGGGACTGCTAGGTT
ACGCTGTTAACACTTAGGA -> CGCTGTTAACACTTAGGAA
AGAAGTCGCCTGCAGAATA -> GAAGTCGCCTGCAGAATAA
AACCATTTTGATGAATTAC -> ACCATTTTGATGAATTACA
TAAAAGGAAAACCAACACT -> AAAAGGAAAACCAACACTA
GCGCCGAGTGGCGATCGGT -> CGCCGAGTGGCGATCGGTG
ACTGATGTATAGTCATTCG -> CTGATGTATAGTCATTCGA
AGAGGTTAAGTGTCAACTG -> GAGGTTAAGTGTCAACTGC
AACTGAGGTTGGCGATAAA -> ACTGAGGTTGGCGATAAAC
AAGCCAAAACAGGTTGCGG -> AGCCAAAACAGGTTGCGGA
AAAATGTTAAATCATGTCC -> AAATGTTAAATCATGTCCT
GGTGCCGGATGCGAGAGTG -> GTGCCGGATGCGAGAGTGC
AGGTTGGGGGCCGTAGCAA -> GGTTGGGGGCCGTAGCAAG
GGCGCAGCTAAGGTCCTCA -> GCGCAGCTAAGGTCCTCAG
GTAACCATGTCTATCATAG -> TAACCATGTCTATCATAGC
TGCGAGAGTGCACCTCCAA -> GCGAGAGTGCACCTCCAAC
GTCGATGTGATGAGACGTT -> TCGATGTGATGAGACGTTC
TTAGTTGTCGATGTGATGA -> TAGTTGTCGATGTGATGAG
GCTAATTGACATTTGCCTT -> CTAATTGACATTTGCCTTG
CGTGCGCCGAGTGGCGATC -> GTGCGCCGAGTGGCGATCG
ATTGGATATACTTGGGTGC -> TTGGATATACTTGGGTGCA
GTGTAGCAGACTTATTTCG -> TGTAGCAGACTTATTTCGA
CCTTGCATAGGCGTAGGTG -> CTTGCATAGGCGTAGGTGA
GACAGATTCGACCGCATCT -> ACAGATTCGACCGCATCTT
GTATTTAAAGTATGGGACC -> TATTTAAAGTATGGGACCG
AAGACTCGCACTAACCCCC -> AGACTCGCACTAACCCCCA
CCGTAGCAAGCATAGCTGT -> CGTAGCAAGCATAGCTGTA
TACTCGAGGTAGGGCGCTA -> ACTCGAGGTAGGGCGCTAG
AATGTTAAATCATGTCCTT -> ATGTTAAATCATGTCCTTA
GTATAGTCATTCGACATCG -> TATAGTCATTCGACATCGT
AGTCGAGTGGTTAAACTAG -> GTCGAGTGGTTAAACTAGA
TGTCGATGTGATGAGACGT -> GTCGATGTGATGAGACGTT
GTAAACCGACTCCCGCATA -> TAAACCGACTCCCGCATAG
TGGACTATATACGCCGAAA -> GGACTATATACGCCGAAAT
GACAATTCTTTCCTCCTTA -> ACAATTCTTTCCTCCTTAG
CTGTGCGACTTAGGCGATG -> TGTGCGACTTAGGCGATGT
CGAGCCCTAATAGTAGTTC -> GAGCCCTAATAGTAGTTCC
GTGCACCTCCAACCTGCAG -> TGCACCTCCAACCTGCAGA
CTTAGTTTGGAACCCACGC -> TTAGTTTGGAACCCACGCC
ATACTTGGGTGCATTTTGG -> TACTTGGGTGCATTTTGGA
TGTGTATATAAGCGGGTCT -> GTGTATATAAGCGGGTCTA
CCTTAGAGGTATTCAGAAA -> CTTAGAGGTATTCAGAAAA
AGACAAACCGCAGCATACG -> GACAAACCGCAGCATACGC
TGCCCTCTATGTAAACCGA -> GCCCTCTATGTAAACCGAC
CGATCGGTGGAGGAGCACT -> GATCGGTGGAGGAGCACTG
AGGTATTCAGAAAAGCGGC -> GGTATTCAGAAAAGCGGCC
TCCTTAGAGGTATTCAGAT -> CCTTAGAGGTATTCAGATG
CTCATGAATGTGCCCTGGC -> TCATGAATGTGCCCTGGCT
TTCCATAAACAGATTTACA -> TCCATAAACAGATTTACAG
AGGTTGGCGATAAACAGGT -> GGTTGGCGATAAACAGGTT
AGTAGTTCCGGTTGGGTGC -> GTAGTTCCGGTTGGGTGCC
AGCCAAAACAGGTTGCGGA -> GCCAAAACAGGTTGCGGAA
GCCTCTTGCAATCCACTTT -> CCTCTTGCAATCCACTTTA
CTACATTATTCGCTGGTGA -> TACATTATTCGCTGGTGAA
GAACTAAAACCGCGAGGAA -> AACTAAAACCGCGAGGAAA
TATATACGCCGAAATGCCG -> ATATACGCCGAAATGCCGC
GGTACCTCACTGTAACCAT -> GTACCTCACTGTAACCATG
ATGCACTAGCCCAGCGTTA -> TGCACTAGCCCAGCGTTAA
TTCTCCTTGCATAGGCGTA -> TCTCCTTGCATAGGCGTAG
CCTCTGCCACCCGGCACTA -> CTCTGCCACCCGGCACTAT
ACCGACTCCCGCATAGACG -> CCGACTCCCGCATAGACGT
TTTTTAGCCCATTATTGTT -> TTTTAGCCCATTATTGTTC
ATGCGCGTGACGCCCTATC -> TGCGCGTGACGCCCTATCA
CCTAATAGTAGTTCCGGCC -> CTAATAGTAGTTCCGGCCT
TAACAGTTCTGGTTAGCTA -> AACAGTTCTGGTTAGCTAA
GTGTATATAAGCGGGTCTA -> TGTATATAAGCGGGTCTAG
CTCACACGTTCGAGATGCA -> TCACACGTTCGAGATGCAC
GTAGTAAGCTATGACACGC -> TAGTAAGCTATGACACGCA
AACAGACATACATGAGCCG -> ACAGACATACATGAGCCGT
TCAACTGCGCCTCGATAAT -> CAACTGCGCCTCGATAATG
GCCCTGGCTTTTCTCGATC -> CCCTGGCTTTTCTCGATCA
GCAAGCATAGCTGTAGTAA -> CAAGCATAGCTGTAGTAAG
GGCCCCCGGATGATATGGG -> GCCCCCGGATGATATGGGC
GGGGGTGCGAGCCCTAATA -> GGGGTGCGAGCCCTAATAG
GCTGTTAACACTTAGGAAT -> CTGTTAACACTTAGGAATG
TTCCGTTTTCAAGGAGGGA -> TCCGTTTTCAAGGAGGGAT
GGGCTCACACGTTCGAGAT -> GGCTCACACGTTCGAGATG
GTGTGAAACCGATTCCCTA -> TGTGAAACCGATTCCCTAG
GTGTCGCGCTTGTACGTGG -> TGTCGCGCTTGTACGTGGT
AATTGTTCGCAAGACGGTG -> ATTGTTCGCAAGACGGTGC
ATATAAGCGGGTCTAGGAA -> TATAAGCGGGTCTAGGAAC
TCCTTAGAGGTATTCAGAC -> CCTTAGAGGTATTCAGACG
GGCCGTAGCAAGCATAGCT -> GCCGTAGCAAGCATAGCTG
TCAGTACAATTTTTAGCCC -> CAGTACAATTTTTAGCCCA
CGCATAGACGTTAACAATT -> GCATAGACGTTAACAATTT
GTATTCAGACGTCGTGAGT -> TATTCAGACGTCGTGAGTC
TAATAAGTGCCAGTTTGTC -> AATAAGTGCCAGTTTGTCA
TACTCGTGTCGCGCTTGTA -> ACTCGTGTCGCGCTTGTAC
CATCTTTTTTATGCGGTAA -> ATCTTTTTTATGCGGTAAC
TTAAGCATGAAGTATAGAG -> TAAGCATGAAGTATAGAGC
GTTAGCCCTTCAAACCCTT -> TTAGCCCTTCAAACCCTTA
CTGCAGATGTTGGTAGAAG -> TGCAGATGTTGGTAGAAGT
TGCGAGAGACAATTCTTTC -> GCGAGAGACAATTCTTTCC
AAAGTGGCCCGTGCGTGTC -> AAGTGGCCCGTGCGTGTCG
ATAAGTGCCAGTTTGTCAC -> TAAGTGCCAGTTTGTCACA
TAAGCGGGTCTAGGAACAG -> AAGCGGGTCTAGGAACAGA
TTTCTCGATCAGATGCACG -> TTCTCGATCAGATGCACGT
ATAATGTTTCTTTCGACTA -> TAATGTTTCTTTCGACTAC
GTACGTGGTCCTTAGAGGT -> TACGTGGTCCTTAGAGGTA
CGACGGTGTGTATATAAGC -> GACGGTGTGTATATAAGCG
GCATTTTGGATGCCTGCCT -> CATTTTGGATGCCTGCCTC
TGTGATACGCCTGCCCAAA -> GTGATACGCCTGCCCAAAG
TTAGTTTATTGGATATACT -> TAGTTTATTGGATATACTT
GGAACTGTACTATCTGAAC -> GAACTGTACTATCTGAACT
ATCCGCCGCATCATAGAGT -> TCCGCCGCATCATAGAGTT
TAGTAGTTCCGGCGGGTAT -> AGTAGTTCCGGCGGGTATT
AGAACTGATGTATAGTCAT -> GAACTGATGTATAGTCATT
ATCCGAGGCATCCTTAGAG -> TCCGAGGCATCCTTAGAGG
CCGGAGGTGGTACCTCACT -> CGGAGGTGGTACCTCACTG
ACCATTCGATTGGACGGAA -> CCATTCGATTGGACGGAAC
ATACGCCTGCCCAAAGCTT -> TACGCCTGCCCAAAGCTTG
ATCTGAACTTCACTGTCAG -> TCTGAACTTCACTGTCAGT
AGGTTAAAGGGTAGGTACG -> GGTTAAAGGGTAGGTACGG
AACGCAGCAACATAACCGG -> ACGCAGCAACATAACCGGT
AGCCCAGCGTTAAGACAAA -> GCCCAGCGTTAAGACAAAC
CTTCTCCTTGCATAGGCGT -> TTCTCCTTGCATAGGCGTA
CCAGTTTGTCACATTGGCT -> CAGTTTGTCACATTGGCTG
GCCCCCGGATGATATGGGC -> CCCCCGGATGATATGGGCC
ATAGCTACATTATTCGCTG -> TAGCTACATTATTCGCTGG
CGCCTCGATAATGTTTCTT -> GCCTCGATAATGTTTCTTT
CTTGGGTGCATTTTGGATG -> TTGGGTGCATTTTGGATGC
CCGGATGATATGGGCCTAA -> CGGATGATATGGGCCTAAC
TCCGAGACTTACTCGAGGT -> CCGAGACTTACTCGAGGTA
GATGATATGGGCCTAACAG -> ATGATATGGGCCTAACAGT
GGTAACTGCGCAGCAACCA -> GTAACTGCGCAGCAACCAC
GGCCTAACAGTTCTGGTTA -> GCCTAACAGTTCTGGTTAG
TGTTTCTTTCGACTACTAC -> GTTTCTTTCGACTACTACA
TGCTCGGGACTTAGTTTGG -> GCTCGGGACTTAGTTTGGA
GAGTGCACCTCCAACCTGC -> AGTGCACCTCCAACCTGCA
CAGATTTACAGCAACATGA -> AGATTTACAGCAACATGAC
GTACCTCACTGTAACCATG -> TACCTCACTGTAACCATGT
ATAGTTAGAATAATGTAGC -> TAGTTAGAATAATGTAGCG
AGGTATTCAGAGAAACTTA -> GGTATTCAGAGAAACTTAG
GAGTTTGGACTATATACGC -> AGTTTGGACTATATACGCC
ATGTGATACGCCTGCCCAA -> TGTGATACGCCTGCCCAAA
CCATTATTGTTCCGTTTTC -> CATTATTGTTCCGTTTTCA
CAGCATACGCAATGCGTAT -> AGCATACGCAATGCGTATT
CGAGTGGCGATCGGTGGAG -> GAGTGGCGATCGGTGGAGG
CCTCGATAATGTTTCTTTC -> CTCGATAATGTTTCTTTCG
CAGTTAGCGGAAGCGTGGA -> AGTTAGCGGAAGCGTGGAA
CGTGCACGAATCCGAGACT -> GTGCACGAATCCGAGACTT
TGCTTGACCTTCTGTGCCC -> GCTTGACCTTCTGTGCCCC
GGTGGTACCTCACTGTAAC -> GTGGTACCTCACTGTAACC
CGAGGTAGGGCGCTAGTCT -> GAGGTAGGGCGCTAGTCTA
CTGCAGTGTCGGTCTCGAG -> TGCAGTGTCGGTCTCGAGG
GCGCTAGTCTACGCTGTTA -> CGCTAGTCTACGCTGTTAA
ATGTGCCCTGGCTTTTCTC -> TGTGCCCTGGCTTTTCTCG
GCGGAAAAAAACCTCAACT -> CGGAAAAAAACCTCAACTA
GATATACTTGGGTGCATTT -> ATATACTTGGGTGCATTTT
GAGGTATTCAGACGTCGTG -> AGGTATTCAGACGTCGTGA
GTAACTGCGCAGCAACCAC -> TAACTGCGCAGCAACCACT
TTTTCAAGGAGGGATACTG -> TTTCAAGGAGGGATACTGG
CAATGCGTATTCATATCGT -> AATGCGTATTCATATCGTA
GGAAGCGTGGAATGTAATA -> GAAGCGTGGAATGTAATAT
TGAGGGTATTTAAAGTATG -> GAGGGTATTTAAAGTATGG
TCGGTCTCGAGGATGCGCG -> CGGTCTCGAGGATGCGCGT
CAGACATACATGAGCCGTT -> AGACATACATGAGCCGTTT
AGTTCTGGTTAGCTAATTG -> GTTCTGGTTAGCTAATTGA
CTGTACTCGTGTCGCGCTT -> TGTACTCGTGTCGCGCTTG
TTCGAGATGCACTAGCCCA -> TCGAGATGCACTAGCCCAG
CCTTAGAGGTATTCAGACG -> CTTAGAGGTATTCAGACGT
CGCACCAGAACCATAAAAG -> GCACCAGAACCATAAAAGG
CGATGTGATGAGACGTTCT -> GATGTGATGAGACGTTCTT
GCCGCAGTTTAGAACTGAT -> CCGCAGTTTAGAACTGATG
TCGAGTGGTTAAACTAGAC -> CGAGTGGTTAAACTAGACT
CGACTCCCGCATAGACGTT -> GACTCCCGCATAGACGTTA
AGTAGTTCCGGCCTGGGCG -> GTAGTTCCGGCCTGGGCGC
AGTGTCGGTCTCGAGGATG -> GTGTCGGTCTCGAGGATGC
GTGGAGGAGCACTGTTCCC -> TGGAGGAGCACTGTTCCCT
TACAGAGGTTAAGTGTCAA -> ACAGAGGTTAAGTGTCAAC
ATGGGACCGCTCTCAGCTG -> TGGGACCGCTCTCAGCTGC
TTAGAGGTATTCAGAAAAG -> TAGAGGTATTCAGAAAAGC
CGGCAATCATCCGCCGCAT -> GGCAATCATCCGCCGCATC
GGGAGTTTGGACTATATAC -> GGAGTTTGGACTATATACG
AACATGACCTGCGGGCTCA -> ACATGACCTGCGGGCTCAC
GTCGCCTGCAGAATAATGG -> TCGCCTGCAGAATAATGGG
CAAATACTGAGGGTATTTA -> AAATACTGAGGGTATTTAA
TAGCCCATTATTGTTCCGT -> AGCCCATTATTGTTCCGTT
TTCTGTACCAACAACAGTT -> TCTGTACCAACAACAGTTA
AGAAATAGAAGCCAAAACA -> GAAATAGAAGCCAAAACAG
AGGTAATAAGTGCCAGTTT -> GGTAATAAGTGCCAGTTTG
AACCGATTCCCTAGCATCC -> ACCGATTCCCTAGCATCCG
TCACTGTCAGTCGAGTGGT -> CACTGTCAGTCGAGTGGTT
TTTTATTCCATAAACAGAT -> TTTATTCCATAAACAGATT
AACCTGCAGATGTTGGTAG -> ACCTGCAGATGTTGGTAGA
TTTCAAGGAGGGATACTGG -> TTCAAGGAGGGATACTGGT
TTCAGAAAAGCGGCCCAGC -> TCAGAAAAGCGGCCCAGCC
CAGATGGGGGTGCGAGCCC -> AGATGGGGGTGCGAGCCCT
GTAATAAGTGCCAGTTTGT -> TAATAAGTGCCAGTTTGTC
TCGTGAGTCGCCCTAATAG -> CGTGAGTCGCCCTAATAGT
CGGTTTCACAGGGGCCCCC -> GGTTTCACAGGGGCCCCCG
TTCGACCGCATCTTTTTTA -> TCGACCGCATCTTTTTTAT
CACTCCGGGCTGTGCGACT -> ACTCCGGGCTGTGCGACTT
GATGAGGTGCCGGATGCGA -> ATGAGGTGCCGGATGCGAG
ACAGCAACATGACCTGCGG -> CAGCAACATGACCTGCGGG
ATCGGTGGAGGAGCACTGT -> TCGGTGGAGGAGCACTGTT
GCAGAACGCAGCAACATAA -> CAGAACGCAGCAACATAAC
GTCTTACATATCGTAAAGT -> TCTTACATATCGTAAAGTG
CAACACTAACCCTCCAGTA -> AACACTAACCCTCCAGTAT
TGTAATATACAGAGGTTAA -> GTAATATACAGAGGTTAAG
CCAGCGTTAAGACAAACCG -> CAGCGTTAAGACAAACCGC
TGAAAAATAAGACTCGCAC -> GAAAAATAAGACTCGCACT
TTAAGTGTCAACTGCGCCT -> TAAGTGTCAACTGCGCCTC
ATACTGGTGCCTCTTTACA -> TACTGGTGCCTCTTTACAA
AATAGTAGTTCCGGTTGGG -> ATAGTAGTTCCGGTTGGGT
TAATGTTTCTTTCGACTAC -> AATGTTTCTTTCGACTACT
AGGTACGGCCTGGGACTGC -> GGTACGGCCTGGGACTGCT
TGTATATAAGCGGGTCTAG -> GTATATAAGCGGGTCTAGG
AAACTAGACTTACAGCCTC -> AACTAGACTTACAGCCTCT
ACTCCGGGCTGTGCGACTT -> CTCCGGGCTGTGCGACTTA
CACTGTAACCATGTCTATC -> ACTGTAACCATGTCTATCA
CATACGCAATGCGTATTCA -> ATACGCAATGCGTATTCAT
TCCTTAGAGGTATTCAGAA -> CCTTAGAGGTATTCAGAAA
TGGGACCGCTCTCAGCTGC -> GGGACCGCTCTCAGCTGCC
TGGGAACTGTACTATCTGA -> GGGAACTGTACTATCTGAA
TCAAACCCTTAATTTTCTG -> CAAACCCTTAATTTTCTGT
CCCTTCGACGGTGTGTATA -> CCTTCGACGGTGTGTATAT
TATTTCAGAATAAACCATT -> ATTTCAGAATAAACCATTT
TATTCAGAAAAGCGGCCCA -> ATTCAGAAAAGCGGCCCAG
ATGTCCTTAGTTGTCGATG -> TGTCCTTAGTTGTCGATGT
ACAGGTTGGGGGCCGTAGC -> CAGGTTGGGGGCCGTAGCA
TGACTCTTCTCCTTGCATA -> GACTCTTCTCCTTGCATAG
AAATCATGTCCTTAGTTGT -> AATCATGTCCTTAGTTGTC
CAACTGAGGTTGGCGATAA -> AACTGAGGTTGGCGATAAA
GTGGCCCTCGCAGATGAGG -> TGGCCCTCGCAGATGAGGT
TGCCTCTTTACAATAGTTA -> GCCTCTTTACAATAGTTAG
CGTGTCGTATAGGTACTGC -> GTGTCGTATAGGTACTGCA
AAGTGGCCCGTGCGTGTCG -> AGTGGCCCGTGCGTGTCGT
TATTCCATAAACAGATTTA -> ATTCCATAAACAGATTTAC
GTTAGCTAATTGACATTTG -> TTAGCTAATTGACATTTGC
CAATCATCCGCCGCATCAT -> AATCATCCGCCGCATCATA
GAGGGATACTGGTGCCTCT -> AGGGATACTGGTGCCTCTT
CTTCACTGTCAGTCGAGTG -> TTCACTGTCAGTCGAGTGG
AATTACATCGTTTAACATA -> ATTACATCGTTTAACATAC
TAGCTGTAGTAAGCTATGA -> AGCTGTAGTAAGCTATGAC
ACAATTTTTAGCCCATTAT -> CAATTTTTAGCCCATTATT
CAGATGAGGTGCCGGATGC -> AGATGAGGTGCCGGATGCG
TAACCCCCAGCCGGAGGTG -> AACCCCCAGCCGGAGGTGG
GCCGGAGGTGGTACCTCAC -> CCGGAGGTGGTACCTCACT
AGAAACTTAGACGCCCTAA -> GAAACTTAGACGCCCTAAT
TCCCGTTCTCATGAATGTG -> CCCGTTCTCATGAATGTGC
GCTAGGTTTTGTAATTAAC -> CTAGGTTTTGTAATTAACA
AGTAGTTCCGGCGGGTATT -> GTAGTTCCGGCGGGTATTT
TCTTCTCCTTGCATAGGCG -> CTTCTCCTTGCATAGGCGT
TACATTATTCGCTGGTGAA -> ACATTATTCGCTGGTGAAC
GAGGGTATTTAAAGTATGG -> AGGGTATTTAAAGTATGGG
CTTCCTTAGAGGTATTCAG -> TTCCTTAGAGGTATTCAGA
GGGTAGGTACGGCCTGGGA -> GGTAGGTACGGCCTGGGAC
AAGCGGGTCTAGGAACAGA -> AGCGGGTCTAGGAACAGAC
TTATTGTCGTTAGTTTATT -> TATTGTCGTTAGTTTATTG
ACTTACAGCCTCTTGCAAT -> CTTACAGCCTCTTGCAATC
TCACTGGGAACTGTACTAT -> CACTGGGAACTGTACTATC
GAATGTAATATACAGAGGT -> AATGTAATATACAGAGGTT
CCGAGACTTACTCGAGGTA -> CGAGACTTACTCGAGGTAG
TATTGTTCCGTTTTCAAGG -> ATTGTTCCGTTTTCAAGGA
ATACATGAGCCGTTTCAGT -> TACATGAGCCGTTTCAGTG
CGTCAACTGAGGTTGGCGA -> GTCAACTGAGGTTGGCGAT
GGGCCCCCGGATGATATGG -> GGCCCCCGGATGATATGGG
GATTCCCTAGCATCCGAGG -> ATTCCCTAGCATCCGAGGC
TTCAAGGAGGGATACTGGT -> TCAAGGAGGGATACTGGTG
CAGGTTGCGGAAAAAAACC -> AGGTTGCGGAAAAAAACCT
GGGACCGCTCTCAGCTGCC -> GGACCGCTCTCAGCTGCCG
TTACAGCCTCTTGCAATCC -> TACAGCCTCTTGCAATCCA
GTGGTCCTTAGAGGTATTC -> TGGTCCTTAGAGGTATTCA
CATCCGCCGCATCATAGAG -> ATCCGCCGCATCATAGAGT
TGGGGGTGCGAGCCCTAAT -> GGGGGTGCGAGCCCTAATA
ACCGCAGCATACGCAATGC -> CCGCAGCATACGCAATGCG
GCCGAAATGCCGCACCAGA -> CCGAAATGCCGCACCAGAA
CAGCTAAGGTCCTCAGTAC -> AGCTAAGGTCCTCAGTACA
AAAGGGTAGGTACGGCCTG -> AAGGGTAGGTACGGCCTGG
CAGCCGGAGGTGGTACCTC -> AGCCGGAGGTGGTACCTCA
CCAGTATTGTCAGAAATAG -> CAGTATTGTCAGAAATAGA
GCTTTTCTCGATCAGATGC -> CTTTTCTCGATCAGATGCA
AACAGTTCTGGTTAGCTAA -> ACAGTTCTGGTTAGCTAAT
ACCAGAACCATAAAAGGAA -> CCAGAACCATAAAAGGAAA
GGTGCCTCTTTACAATAGT -> GTGCCTCTTTACAATAGTT
TGTCAACTGCGCCTCGATA -> GTCAACTGCGCCTCGATAA
TTTTCTCGATCAGATGCAC -> TTTCTCGATCAGATGCACG
TCAGATGCACGTGACAAAC -> CAGATGCACGTGACAAACA
TATAGAGCGTTAGCCCTTC -> ATAGAGCGTTAGCCCTTCA
TACGCTGTTAACACTTAGG -> ACGCTGTTAACACTTAGGA
ATCTTTTTTATGCGGTAAC -> TCTTTTTTATGCGGTAACT
TAGCCCAGCGTTAAGACAA -> AGCCCAGCGTTAAGACAAA
CAAGGAGGGATACTGGTGC -> AAGGAGGGATACTGGTGCC
ACGCAGAACGCAGCAACAT -> CGCAGAACGCAGCAACATA
TCGTATAGGTACTGCAGTG -> CGTATAGGTACTGCAGTGT
GGTATTTCAGAATAAACCA -> GTATTTCAGAATAAACCAT
TAAACAGATTTACAGCAAC -> AAACAGATTTACAGCAACA
CTTTCGACTACTACACCGG -> TTTCGACTACTACACCGGC
TTACTCGAGGTAGGGCGCT -> TACTCGAGGTAGGGCGCTA
ACGTCGTGAGTCGCCCTAA -> CGTCGTGAGTCGCCCTAAT
GGACTATATACGCCGAAAT -> GACTATATACGCCGAAATG
GCAAGACGGTGCTTCCTTA -> CAAGACGGTGCTTCCTTAG
AGAGTGCACCTCCAACCTG -> GAGTGCACCTCCAACCTGC
TCTAGGAACAGACATACAT -> CTAGGAACAGACATACATG
TTGTTCCGTTTTCAAGGAG -> TGTTCCGTTTTCAAGGAGG
AATAGTAGTTCCGGCCTGG -> ATAGTAGTTCCGGCCTGGG
TCTTTACAATAGTTAGAAT -> CTTTACAATAGTTAGAATA
AATAAGTGCCAGTTTGTCA -> ATAAGTGCCAGTTTGTCAC
TGGGGAGTTTGGACTATAT -> GGGGAGTTTGGACTATATA
GTAGAAGTCGCCTGCAGAA -> TAGAAGTCGCCTGCAGAAT
GCGTGGAATGTAATATACA -> CGTGGAATGTAATATACAG
CAACTACCGCAACTGCGGT -> AACTACCGCAACTGCGGTG
TTCGATTGGACGGAACTAA -> TCGATTGGACGGAACTAAA
AGCCCTAATAGTAGTTCCG -> GCCCTAATAGTAGTTCCGG,GCCCTAATAGTAGTTCCGG
GAATGTGCCCTGGCTTTTC -> AATGTGCCCTGGCTTTTCT
ACCTCAACTACCGCAACTG -> CCTCAACTACCGCAACTGC
GTTGTCGATGTGATGAGAC -> TTGTCGATGTGATGAGACG
GAAACCGATTCCCTAGCAT -> AAACCGATTCCCTAGCATC
ACTATGATTCCAAATTGTT -> CTATGATTCCAAATTGTTC
TGTCGGTCTCGAGGATGCG -> GTCGGTCTCGAGGATGCGC
CACGTTCGAGATGCACTAG -> ACGTTCGAGATGCACTAGC
ACTATATACGCCGAAATGC -> CTATATACGCCGAAATGCC
TTTTGTAATTAACACCATT -> TTTGTAATTAACACCATTC
CATATCGTACGCTGTACTC -> ATATCGTACGCTGTACTCG
AGGTGCCGGATGCGAGAGT -> GGTGCCGGATGCGAGAGTG
CGAATGTGATACGCCTGCC -> GAATGTGATACGCCTGCCC
CCCTTAATTTTCTGTACCA -> CCTTAATTTTCTGTACCAA
GAGGAGCACTGTTCCCTTC -> AGGAGCACTGTTCCCTTCG
CTCCTTGCATAGGCGTAGG -> TCCTTGCATAGGCGTAGGT
CCTGGCTTTTCTCGATCAG -> CTGGCTTTTCTCGATCAGA
CGCCTGCAGAATAATGGGG -> GCCTGCAGAATAATGGGGA
GCTTGACCTTCTGTGCCCC -> CTTGACCTTCTGTGCCCCC
TATTCAGATGGGGGTGCGA -> ATTCAGATGGGGGTGCGAG
ACTAAAACCGCGAGGAAAA -> CTAAAACCGCGAGGAAAAT
CTAATAGTAGTTCCGGCGG -> TAATAGTAGTTCCGGCGGG
GTACTCGTGTCGCGCTTGT -> TACTCGTGTCGCGCTTGTA
TCTGTGCCCCCGTGCACGA -> CTGTGCCCCCGTGCACGAA
TAGTTCCGGTTGGGTGCCC -> AGTTCCGGTTGGGTGCCCC
TTCGCTGGTGAACATAGAC -> TCGCTGGTGAACATAGACT
ACTAGCCCAGCGTTAAGAC -> CTAGCCCAGCGTTAAGACA
TAGACGTTAACAATTTATA -> AGACGTTAACAATTTATAT
TAGACTATATCCGTGCGCC -> AGACTATATCCGTGCGCCG
CCCAGCCGGAGGTGGTACC -> CCAGCCGGAGGTGGTACCT
GATTCCAAATTGTTCGCAA -> ATTCCAAATTGTTCGCAAG
AATACTGAGGGTATTTAAA -> ATACTGAGGGTATTTAAAG
TGTAACCATGTCTATCATA -> GTAACCATGTCTATCATAG
AGTTCCGGCGGGTATTTCA -> GTTCCGGCGGGTATTTCAG
CGTTTAACATACGCCTTGC -> GTTTAACATACGCCTTGCT
AATGGGGAGTTTGGACTAT -> ATGGGGAGTTTGGACTATA
GAGGTGGTACCTCACTGTA -> AGGTGGTACCTCACTGTAA
CGGTGCTTCCTTAGAGGTA -> GGTGCTTCCTTAGAGGTAT
TTGGTAGAAGTCGCCTGCA -> TGGTAGAAGTCGCCTGCAG
GGATGCCTGCCTCTGCCAC -> GATGCCTGCCTCTGCCACC
TCGTCAACTGAGGTTGGCG -> CGTCAACTGAGGTTGGCGA
ACAGGTTAAAGGGTAGGTA -> CAGGTTAAAGGGTAGGTAC
GTGTCAACTGCGCCTCGAT -> TGTCAACTGCGCCTCGATA
AGAGGTATTCAGATGGGGG -> GAGGTATTCAGATGGGGGT
CTATATCCGTGCGCCGAGT -> TATATCCGTGCGCCGAGTG
TTAATTTTCTGTACCAACA -> TAATTTTCTGTACCAACAA
TCGTTAGTTTATTGGATAT -> CGTTAGTTTATTGGATATA
AAACCAACACTAACCCTCC -> AACCAACACTAACCCTCCA
GTATTCAGAAAAGCGGCCC -> TATTCAGAAAAGCGGCCCA
TTGTACGTGGTCCTTAGAG -> TGTACGTGGTCCTTAGAGG
GCATCCGAGGCATCCTTAG -> CATCCGAGGCATCCTTAGA
GAACGCAGCAACATAACCG -> AACGCAGCAACATAACCGG
CTTCGACGGTGTGTATATA -> TTCGACGGTGTGTATATAA
TCGACGGTGTGTATATAAG -> CGACGGTGTGTATATAAGC
TCATGTCCTTAGTTGTCGA -> CATGTCCTTAGTTGTCGAT
TAACTGCGCAGCAACCACT -> AACTGCGCAGCAACCACTC
GTTTGGACTATATACGCCG -> TTTGGACTATATACGCCGA
TTTTTTATGCGGTAACTGC -> TTTTTATGCGGTAACTGCG
CTTGCTCGGGACTTAGTTT -> TTGCTCGGGACTTAGTTTG
GGGTGCCCCGAGCGACCGG -> GGTGCCCCGAGCGACCGGT
AGCGACCGGTGGCCCTCGC -> GCGACCGGTGGCCCTCGCA
AGGGATACTGGTGCCTCTT -> GGGATACTGGTGCCTCTTT
ATAAACAGGTTAAAGGGTA -> TAAACAGGTTAAAGGGTAG
CAGAGAAACTTAGACGCCC -> AGAGAAACTTAGACGCCCT
ATTGTTCCGTTTTCAAGGA -> TTGTTCCGTTTTCAAGGAG
CCGCCGCATCATAGAGTTA -> CGCCGCATCATAGAGTTAT
AATAAACCATTTTGATGAA -> ATAAACCATTTTGATGAAT
TCAAATACTGAGGGTATTT -> CAAATACTGAGGGTATTTA
CCCTAATAGTAGTTCCGGC -> CCTAATAGTAGTTCCGGCC,CCTAATAGTAGTTCCGGCG
CGCCCTATCAAATACTGAG -> GCCCTATCAAATACTGAGG
CTAGGTTTTGTAATTAACA -> TAGGTTTTGTAATTAACAC
TGAGCCGTTTCAGTGCAAG -> GAGCCGTTTCAGTGCAAGG
AACTGATGTATAGTCATTC -> ACTGATGTATAGTCATTCG
CTTGACCTTCTGTGCCCCC -> TTGACCTTCTGTGCCCCCG
ATTCAGAGAAACTTAGACG -> TTCAGAGAAACTTAGACGC
CTGGGCGCAGCTAAGGTCC -> TGGGCGCAGCTAAGGTCCT
TGGGTGCCCCGAGCGACCG -> GGGTGCCCCGAGCGACCGG
GGACTGCTAGGTTTTGTAA -> GACTGCTAGGTTTTGTAAT
AGACTTACTCGAGGTAGGG -> GACTTACTCGAGGTAGGGC
AGCCGGAGGTGGTACCTCA -> GCCGGAGGTGGTACCTCAC
ATTTATATGCGAGAGACAA -> TTTATATGCGAGAGACAAT
TTGTTCGCAAGACGGTGCT -> TGTTCGCAAGACGGTGCTT
GGGTCTAGGAACAGACATA -> GGTCTAGGAACAGACATAC
GTTGGTAGAAGTCGCCTGC -> TTGGTAGAAGTCGCCTGCA
TCGACCGCATCTTTTTTAT -> CGACCGCATCTTTTTTATG
CCTCTATGTAAACCGACTC -> CTCTATGTAAACCGACTCC
GAGTGGTTAAACTAGACTT -> AGTGGTTAAACTAGACTTA
GACGGTGTGTATATAAGCG -> ACGGTGTGTATATAAGCGG
CGATCAGATGCACGTGACA -> GATCAGATGCACGTGACAA
CAAGACGGTGCTTCCTTAG -> AAGACGGTGCTTCCTTAGA
GGTTGCGGAAAAAAACCTC -> GTTGCGGAAAAAAACCTCA
TTGACATTTGCCTTGAAAA -> TGACATTTGCCTTGAAAAA
TTACAGCAACATGACCTGC -> TACAGCAACATGACCTGCG
TTCCGGTTGGGTGCCCCGA -> TCCGGTTGGGTGCCCCGAG
TTAAAGGGTAGGTACGGCC -> TAAAGGGTAGGTACGGCCT
GCAGCAACCACTCCGGGCT -> CAGCAACCACTCCGGGCTG
GTACTATCTGAACTTCACT -> TACTATCTGAACTTCACTG
TAAAGGGTAGGTACGGCCT -> AAAGGGTAGGTACGGCCTG
ACTTGGGTGCATTTTGGAT -> CTTGGGTGCATTTTGGATG
TGGGGGCCGTAGCAAGCAT -> GGGGGCCGTAGCAAGCATA
CATAAAAGGAAAACCAACA -> ATAAAAGGAAAACCAACAC
CTGCCACCCGGCACTATGA -> TGCCACCCGGCACTATGAT
GGGGAGTTTGGACTATATA -> GGGAGTTTGGACTATATAC
TTCCTCCTTAGAGGTATTC -> TCCTCCTTAGAGGTATTCA
CATAGGCGTAGGTGAGGCA -> ATAGGCGTAGGTGAGGCAC
GTAGTTCCGGTTGGGTGCC -> TAGTTCCGGTTGGGTGCCC
TTCGACGGTGTGTATATAA -> TCGACGGTGTGTATATAAG
GAGAGTGCACCTCCAACCT -> AGAGTGCACCTCCAACCTG
AGCACTGTTCCCTTCGACG -> GCACTGTTCCCTTCGACGG
CGCTCTCAGCTGCCGAAAC -> GCTCTCAGCTGCCGAAACG
CAACCTGCAGATGTTGGTA -> AACCTGCAGATGTTGGTAG
TGCGGTAACTGCGCAGCAA -> GCGGTAACTGCGCAGCAAC
GTCGAGTGGTTAAACTAGA -> TCGAGTGGTTAAACTAGAC
TTGTCACATTGGCTGTGCT -> TGTCACATTGGCTGTGCTT
CGAGCGACCGGTGGCCCTC -> GAGCGACCGGTGGCCCTCG
TCGACATCGTCTTACATAT -> CGACATCGTCTTACATATC
AGGTAGGGCGCTAGTCTAC -> GGTAGGGCGCTAGTCTACG
TAGCAAGCATAGCTGTAGT -> AGCAAGCATAGCTGTAGTA
GTATTGTCAGAAATAGAAG -> TATTGTCAGAAATAGAAGC
AGACAATTCTTTCCTCCTT -> GACAATTCTTTCCTCCTTA
CATTCGATTGGACGGAACT -> ATTCGATTGGACGGAACTA
GCGAGAGACAATTCTTTCC -> CGAGAGACAATTCTTTCCT
GTGCCGGATGCGAGAGTGC -> TGCCGGATGCGAGAGTGCA
GCAGAATAATGGGGAGTTT -> CAGAATAATGGGGAGTTTG
TCCACTTTACCGTGTGAAA -> CCACTTTACCGTGTGAAAC
ATAGTAGTTCCGGCCTGGG -> TAGTAGTTCCGGCCTGGGC
CCAAAACAGGTTGCGGAAA -> CAAAACAGGTTGCGGAAAA
AATTGACATTTGCCTTGAA -> ATTGACATTTGCCTTGAAA
GTGCATTTTGGATGCCTGC -> TGCATTTTGGATGCCTGCC
TATTCGCTGGTGAACATAG -> ATTCGCTGGTGAACATAGA
AGAAAAGCGGCCCAGCCCT -> GAAAAGCGGCCCAGCCCTA
ATATACTTGGGTGCATTTT -> TATACTTGGGTGCATTTTG
GACCGGTGGCCCTCGCAGA -> ACCGGTGGCCCTCGCAGAT
CGATTGGACGGAACTAAAA -> GATTGGACGGAACTAAAAC
AGCAGACTTATTTCGACAG -> GCAGACTTATTTCGACAGA
TTTAAAGTATGGGACCGCT -> TTAAAGTATGGGACCGCTC
GTGCACGAATCCGAGACTT -> TGCACGAATCCGAGACTTA
GGGGCCCCCGGATGATATG -> GGGCCCCCGGATGATATGG
ATTCGATTGGACGGAACTA -> TTCGATTGGACGGAACTAA
CAAACCCTTAATTTTCTGT -> AAACCCTTAATTTTCTGTA
AAGACAAACCGCAGCATAC -> AGACAAACCGCAGCATACG
AACTGTACTATCTGAACTT -> ACTGTACTATCTGAACTTC
TCGGTGGAGGAGCACTGTT -> CGGTGGAGGAGCACTGTTC
GCCAGTTTGTCACATTGGC -> CCAGTTTGTCACATTGGCT
GTTCCGGTTTCACAGGGGC -> TTCCGGTTTCACAGGGGCC
CCCTGGCTTTTCTCGATCA -> CCTGGCTTTTCTCGATCAG
TAAGACTCGCACTAACCCC -> AAGACTCGCACTAACCCCC
CTAGGAACAGACATACATG -> TAGGAACAGACATACATGA
TGGCTGTGCTTGACCTTCT -> GGCTGTGCTTGACCTTCTG
GGGTGCGAGCCCTAATAGT -> GGTGCGAGCCCTAATAGTA
CCGGCCTGGGCGCAGCTAA -> CGGCCTGGGCGCAGCTAAG
CCCGAGCGACCGGTGGCCC -> CCGAGCGACCGGTGGCCCT
CATCGTCTTACATATCGTA -> ATCGTCTTACATATCGTAA
TACGGCCTGGGACTGCTAG -> ACGGCCTGGGACTGCTAGG
AGTTTATTGGATATACTTG -> GTTTATTGGATATACTTGG
TTATTCGCTGGTGAACATA -> TATTCGCTGGTGAACATAG
GCACTGTTCCCTTCGACGG -> CACTGTTCCCTTCGACGGT
GAGCCGTTTCAGTGCAAGG -> AGCCGTTTCAGTGCAAGGT
TTAGGAATGTCCCGTTCTC -> TAGGAATGTCCCGTTCTCA
CCCAAAGCTTGTTGTAAAA -> CCAAAGCTTGTTGTAAAAG
GAACTTCACTGTCAGTCGA -> AACTTCACTGTCAGTCGAG
GGGGTGCGAGCCCTAATAG -> GGGTGCGAGCCCTAATAGT
GTGCGTGTCGTATAGGTAC -> TGCGTGTCGTATAGGTACT
CCTCTTTACAATAGTTAGA -> CTCTTTACAATAGTTAGAA
TTAGCCCTTCAAACCCTTA -> TAGCCCTTCAAACCCTTAA
TTTCAGTGCAAGGTAATAA -> TTCAGTGCAAGGTAATAAG
CTCAACTACCGCAACTGCG -> TCAACTACCGCAACTGCGG
GCGGCCCAGCCCTAATAGT -> CGGCCCAGCCCTAATAGTA
CGTATTCATATCGTACGCT -> GTATTCATATCGTACGCTG
CATAACCGGTCAACGTGCC -> ATAACCGGTCAACGTGCCC
AACACTTAGGAATGTCCCG -> ACACTTAGGAATGTCCCGT
GTAGTTCCGGTTTCACAGG -> TAGTTCCGGTTTCACAGGG
GACGTCGTGAGTCGCCCTA -> ACGTCGTGAGTCGCCCTAA
CCGTGCGCCGAGTGGCGAT -> CGTGCGCCGAGTGGCGATC
GCAATGCGTATTCATATCG -> CAATGCGTATTCATATCGT
GCCCTAATAGTAGTTCCGG -> CCCTAATAGTAGTTCCGGT,CCCTAATAGTAGTTCCGGC,CCCTAATAGTAGTTCCGGC,CCCTAATAGTAGTTCCGGT
ATAAGACTCGCACTAACCC -> TAAGACTCGCACTAACCCC
TGCAGATGTTGGTAGAAGT -> GCAGATGTTGGTAGAAGTC
GTCGCGCTTGTACGTGGTC -> TCGCGCTTGTACGTGGTCC
AGGGTAGGTACGGCCTGGG -> GGGTAGGTACGGCCTGGGA
ATGCGAGAGACAATTCTTT -> TGCGAGAGACAATTCTTTC
AACGAATGTGATACGCCTG -> ACGAATGTGATACGCCTGC
TTAGAGGTATTCAGACGTC -> TAGAGGTATTCAGACGTCG
TTCAGTGCAAGGTAATAAG -> TCAGTGCAAGGTAATAAGT
CAGCCCTAATAGTAGTTCC -> AGCCCTAATAGTAGTTCCG
CAATCCACTTTACCGTGTG -> AATCCACTTTACCGTGTGA
AGCAACCACTCCGGGCTGT -> GCAACCACTCCGGGCTGTG
TCCTTAGAGGTATTCAGAG -> CCTTAGAGGTATTCAGAGA
TGGTTAAACTAGACTTACA -> GGTTAAACTAGACTTACAG
GCATACGCAATGCGTATTC -> CATACGCAATGCGTATTCA
ACCATGTCTATCATAGCTA -> CCATGTCTATCATAGCTAC
ATGTATAGTCATTCGACAT -> TGTATAGTCATTCGACATC
TATAAGCGGGTCTAGGAAC -> ATAAGCGGGTCTAGGAACA
TCCGTTTTCAAGGAGGGAT -> CCGTTTTCAAGGAGGGATA
TGAGTCGCCCTAATAGTAG -> GAGTCGCCCTAATAGTAGT
ACCCGGCACTATGATTCCA -> CCCGGCACTATGATTCCAA
TGAGGTGCCGGATGCGAGA -> GAGGTGCCGGATGCGAGAG
CCGTGCACGAATCCGAGAC -> CGTGCACGAATCCGAGACT
ATTTGCCTTGAAAAATAAG -> TTTGCCTTGAAAAATAAGA
GCCGGATGCGAGAGTGCAC -> CCGGATGCGAGAGTGCACC
ATTCCAAATTGTTCGCAAG -> TTCCAAATTGTTCGCAAGA
TACTTGGGTGCATTTTGGA -> ACTTGGGTGCATTTTGGAT
GACCTTCTGTGCCCCCGTG -> ACCTTCTGTGCCCCCGTGC
ATTAACACCATTCGATTGG -> TTAACACCATTCGATTGGA
AAGTATAGAGCGTTAGCCC -> AGTATAGAGCGTTAGCCCT
CCTAATAGTAGTTCCGGCG -> CTAATAGTAGTTCCGGCGG
GTAATTAACACCATTCGAT -> TAATTAACACCATTCGATT
GGTGAACATAGACTATATC -> GTGAACATAGACTATATCC
GTTGGCGATAAACAGGTTA -> TTGGCGATAAACAGGTTAA
TACGTGGTCCTTAGAGGTA -> ACGTGGTCCTTAGAGGTAT
TACGCCTGCCCAAAGCTTG -> ACGCCTGCCCAAAGCTTGT
CTCTTGCAATCCACTTTAC -> TCTTGCAATCCACTTTACC
ATCATGTCCTTAGTTGTCG -> TCATGTCCTTAGTTGTCGA
TGCGGTGAGTTTCGTCAAC -> GCGGTGAGTTTCGTCAACT
TCTGAACTTCACTGTCAGT -> CTGAACTTCACTGTCAGTC
CTAGACTTACAGCCTCTTG -> TAGACTTACAGCCTCTTGC
AACAACAGTTAGCGGAAGC -> ACAACAGTTAGCGGAAGCG
AGGTCCTCAGTACAATTTT -> GGTCCTCAGTACAATTTTT
GGAGTTTGGACTATATACG -> GAGTTTGGACTATATACGC
AATGTGCCCTGGCTTTTCT -> ATGTGCCCTGGCTTTTCTC
CTGGGAACTGTACTATCTG -> TGGGAACTGTACTATCTGA
AGAGTTATTGTCGTTAGTT -> GAGTTATTGTCGTTAGTTT
TAGCATCCGAGGCATCCTT -> AGCATCCGAGGCATCCTTA
GTGCCCCCGTGCACGAATC -> TGCCCCCGTGCACGAATCC
GCCCAGCGTTAAGACAAAC -> CCCAGCGTTAAGACAAACC
CCGGTCAACGTGCCCTCTA -> CGGTCAACGTGCCCTCTAT
AGTATGGGACCGCTCTCAG -> GTATGGGACCGCTCTCAGC
TCCAACCTGCAGATGTTGG -> CCAACCTGCAGATGTTGGT
CTGTCAGTCGAGTGGTTAA -> TGTCAGTCGAGTGGTTAAA
GGTTTTGTAATTAACACCA -> GTTTTGTAATTAACACCAT
CTCGAGGTAGGGCGCTAGT -> TCGAGGTAGGGCGCTAGTC
TTTCAGAATAAACCATTTT -> TTCAGAATAAACCATTTTG
TATACTTGGGTGCATTTTG -> ATACTTGGGTGCATTTTGG
ACACCGGCAATCATCCGCC -> CACCGGCAATCATCCGCCG
GGATACTGGTGCCTCTTTA -> GATACTGGTGCCTCTTTAC
ACTGCGGTGAGTTTCGTCA -> CTGCGGTGAGTTTCGTCAA
GTACGCTGTACTCGTGTCG -> TACGCTGTACTCGTGTCGC
TTTCGTCAACTGAGGTTGG -> TTCGTCAACTGAGGTTGGC
TGTGACTCTTCTCCTTGCA -> GTGACTCTTCTCCTTGCAT
CCCGGCACTATGATTCCAA -> CCGGCACTATGATTCCAAA
GCCACCCGGCACTATGATT -> CCACCCGGCACTATGATTC
CCATTCGATTGGACGGAAC -> CATTCGATTGGACGGAACT
CTTTTTTATGCGGTAACTG -> TTTTTTATGCGGTAACTGC
ATGCCTGCCTCTGCCACCC -> TGCCTGCCTCTGCCACCCG
TAAGTGTCAACTGCGCCTC -> AAGTGTCAACTGCGCCTCG
GCCGAGTGGCGATCGGTGG -> CCGAGTGGCGATCGGTGGA
AGTGCAAGGTAATAAGTGC -> GTGCAAGGTAATAAGTGCC
CCTGCAGAATAATGGGGAG -> CTGCAGAATAATGGGGAGT
CGTACGCTGTACTCGTGTC -> GTACGCTGTACTCGTGTCG
TGCAAGGTAATAAGTGCCA -> GCAAGGTAATAAGTGCCAG
TGTAGTAAGCTATGACACG -> GTAGTAAGCTATGACACGC
TTAACAATTTATATGCGAG -> TAACAATTTATATGCGAGA
AGTGCCAGTTTGTCACATT -> GTGCCAGTTTGTCACATTG
GCTAAGGTCCTCAGTACAA -> CTAAGGTCCTCAGTACAAT
TCTCAGCTGCCGAAACGAA -> CTCAGCTGCCGAAACGAAT
TAGAACTGATGTATAGTCA -> AGAACTGATGTATAGTCAT
GAGAAACTTAGACGCCCTA -> AGAAACTTAGACGCCCTAA
TCATAGAGTTATTGTCGTT -> CATAGAGTTATTGTCGTTA
TCAGTCGAGTGGTTAAACT -> CAGTCGAGTGGTTAAACTA
CGGAGGTGGTACCTCACTG -> GGAGGTGGTACCTCACTGT
TGTGCCCTGGCTTTTCTCG -> GTGCCCTGGCTTTTCTCGA
TTCTCGATCAGATGCACGT -> TCTCGATCAGATGCACGTG
AATATACAGAGGTTAAGTG -> ATATACAGAGGTTAAGTGT
AAACCCTTAATTTTCTGTA -> AACCCTTAATTTTCTGTAC
GGTGGAGGAGCACTGTTCC -> GTGGAGGAGCACTGTTCCC
GTTTCGTCAACTGAGGTTG -> TTTCGTCAACTGAGGTTGG
ATGCGAGAGTGCACCTCCA -> TGCGAGAGTGCACCTCCAA
GACAAACCGCAGCATACGC -> ACAAACCGCAGCATACGCA
TCCGTGCGCCGAGTGGCGA -> CCGTGCGCCGAGTGGCGAT
CTTGTACGTGGTCCTTAGA -> TTGTACGTGGTCCTTAGAG
AACATACGCCTTGCTCGGG -> ACATACGCCTTGCTCGGGA
GCGCAGCAACCACTCCGGG -> CGCAGCAACCACTCCGGGC
GTTCCGGCGGGTATTTCAG -> TTCCGGCGGGTATTTCAGA
TCCGGCGGGTATTTCAGAA -> CCGGCGGGTATTTCAGAAT
AGCCCATTATTGTTCCGTT -> GCCCATTATTGTTCCGTTT
CGCAGCAACATAACCGGTC -> GCAGCAACATAACCGGTCA
AGTCTACGCTGTTAACACT -> GTCTACGCTGTTAACACTT
TTACAATAGTTAGAATAAT -> TACAATAGTTAGAATAATG
ACCGCATCTTTTTTATGCG -> CCGCATCTTTTTTATGCGG
GGTCAACGTGCCCTCTATG -> GTCAACGTGCCCTCTATGT
CCACGCCGCAGTTTAGAAC -> CACGCCGCAGTTTAGAACT
ATGTTAAATCATGTCCTTA -> TGTTAAATCATGTCCTTAG
ATGATTCCAAATTGTTCGC -> TGATTCCAAATTGTTCGCA
AGTTATTGTCGTTAGTTTA -> GTTATTGTCGTTAGTTTAT
GGCTTTTCTCGATCAGATG -> GCTTTTCTCGATCAGATGC
TAGGTACGGCCTGGGACTG -> AGGTACGGCCTGGGACTGC
TTGGACGGAACTAAAACCG -> TGGACGGAACTAAAACCGC
GAATAATGGGGAGTTTGGA -> AATAATGGGGAGTTTGGAC
GGCTCACACGTTCGAGATG -> GCTCACACGTTCGAGATGC
TAGCTACATTATTCGCTGG -> AGCTACATTATTCGCTGGT
ACGCTGTACTCGTGTCGCG -> CGCTGTACTCGTGTCGCGC
GCAATCATCCGCCGCATCA -> CAATCATCCGCCGCATCAT
CTTTCCTCCTTAGAGGTAT -> TTTCCTCCTTAGAGGTATT
CTAACAGTTCTGGTTAGCT -> TAACAGTTCTGGTTAGCTA
TTTTGGATGCCTGCCTCTG -> TTTGGATGCCTGCCTCTGC
CCCTCCAGTATTGTCAGAA -> CCTCCAGTATTGTCAGAAA
AGTGGCGATCGGTGGAGGA -> GTGGCGATCGGTGGAGGAG
TAATTAACACCATTCGATT -> AATTAACACCATTCGATTG
TATGCGGTAACTGCGCAGC -> ATGCGGTAACTGCGCAGCA
ATTCGACATCGTCTTACAT -> TTCGACATCGTCTTACATA
GGTATTCAGAGAAACTTAG -> GTATTCAGAGAAACTTAGA
TGCGACTTAGGCGATGTGA -> GCGACTTAGGCGATGTGAC
GCCGCACCAGAACCATAAA -> CCGCACCAGAACCATAAAA
GTTCCGGCCTGGGCGCAGC -> TTCCGGCCTGGGCGCAGCT
ACCGCTCTCAGCTGCCGAA -> CCGCTCTCAGCTGCCGAAA
AACCCACGCCGCAGTTTAG -> ACCCACGCCGCAGTTTAGA
CAGACGTCGTGAGTCGCCC -> AGACGTCGTGAGTCGCCCT
CATCATAGAGTTATTGTCG -> ATCATAGAGTTATTGTCGT
TTAGAGGTATTCAGAGAAA -> TAGAGGTATTCAGAGAAAC
TGACATTTGCCTTGAAAAA -> GACATTTGCCTTGAAAAAT
CACTGGGAACTGTACTATC -> ACTGGGAACTGTACTATCT
TGAATTACATCGTTTAACA -> GAATTACATCGTTTAACAT
AGCAACATGACCTGCGGGC -> GCAACATGACCTGCGGGCT
TATTCAGACGTCGTGAGTC -> ATTCAGACGTCGTGAGTCG
TCGACAGATTCGACCGCAT -> CGACAGATTCGACCGCATC
ACGCAATGCGTATTCATAT -> CGCAATGCGTATTCATATC
GGAACCCACGCCGCAGTTT -> GAACCCACGCCGCAGTTTA
ACTATCTGAACTTCACTGT -> CTATCTGAACTTCACTGTC
CACGCAGAACGCAGCAACA -> ACGCAGAACGCAGCAACAT
GGTTTCACAGGGGCCCCCG -> GTTTCACAGGGGCCCCCGG
GTTGGGGGCCGTAGCAAGC -> TTGGGGGCCGTAGCAAGCA
GTCAGAAATAGAAGCCAAA -> TCAGAAATAGAAGCCAAAA
CCCGTTCTCATGAATGTGC -> CCGTTCTCATGAATGTGCC
AAGCGGCCCAGCCCTAATA -> AGCGGCCCAGCCCTAATAG
GCCTTGAAAAATAAGACTC -> CCTTGAAAAATAAGACTCG
GACTCGCACTAACCCCCAG -> ACTCGCACTAACCCCCAGC
GTGGCGATCGGTGGAGGAG -> TGGCGATCGGTGGAGGAGC
ATACGCAATGCGTATTCAT -> TACGCAATGCGTATTCATA
ATTGTCGTTAGTTTATTGG -> TTGTCGTTAGTTTATTGGA
CCAACACTAACCCTCCAGT -> CAACACTAACCCTCCAGTA
TCGCAGATGAGGTGCCGGA -> CGCAGATGAGGTGCCGGAT
CGTTAACAATTTATATGCG -> GTTAACAATTTATATGCGA
TATTTAAAGTATGGGACCG -> ATTTAAAGTATGGGACCGC
CGATAAACAGGTTAAAGGG -> GATAAACAGGTTAAAGGGT
CTGGTGCCTCTTTACAATA -> TGGTGCCTCTTTACAATAG
TTTTTATGCGGTAACTGCG -> TTTTATGCGGTAACTGCGC
TGGCTTTTCTCGATCAGAT -> GGCTTTTCTCGATCAGATG
GCTGTGCGACTTAGGCGAT -> CTGTGCGACTTAGGCGATG
GTTTAAGCATGAAGTATAG -> TTTAAGCATGAAGTATAGA
TTCGACTACTACACCGGCA -> TCGACTACTACACCGGCAA
CCCCGTGCACGAATCCGAG -> CCCGTGCACGAATCCGAGA
TATTTCGACAGATTCGACC -> ATTTCGACAGATTCGACCG
TTGGATGCCTGCCTCTGCC -> TGGATGCCTGCCTCTGCCA
CGTTAAGACAAACCGCAGC -> GTTAAGACAAACCGCAGCA
TGCGTGTCGTATAGGTACT -> GCGTGTCGTATAGGTACTG
GCCGAAACGAATGTGATAC -> CCGAAACGAATGTGATACG
GGCGCTAGTCTACGCTGTT -> GCGCTAGTCTACGCTGTTA
TAACATACGCCTTGCTCGG -> AACATACGCCTTGCTCGGG
TGCCGCACCAGAACCATAA -> GCCGCACCAGAACCATAAA
ACCACTCCGGGCTGTGCGA -> CCACTCCGGGCTGTGCGAC
GTTTAGAACTGATGTATAG -> TTTAGAACTGATGTATAGT
ATGTCTATCATAGCTACAT -> TGTCTATCATAGCTACATT
GTACCAACAACAGTTAGCG -> TACCAACAACAGTTAGCGG
CAGCGTTAAGACAAACCGC -> AGCGTTAAGACAAACCGCA
TTCGCAAGACGGTGCTTCC -> TCGCAAGACGGTGCTTCCT
CGCAACTGCGGTGAGTTTC -> GCAACTGCGGTGAGTTTCG
TGACGCCCTATCAAATACT -> GACGCCCTATCAAATACTG
TAACCGGTCAACGTGCCCT -> AACCGGTCAACGTGCCCTC
AACCATAAAAGGAAAACCA -> ACCATAAAAGGAAAACCAA
ACCGCGAGGAAAATGTTAA -> CCGCGAGGAAAATGTTAAA
TGTTGTAAAAGTTTAAGCA -> GTTGTAAAAGTTTAAGCAT
AGAACGCAGCAACATAACC -> GAACGCAGCAACATAACCG
GTGCTTGACCTTCTGTGCC -> TGCTTGACCTTCTGTGCCC
AACAGATTTACAGCAACAT -> ACAGATTTACAGCAACATG
GTATTTCAGAATAAACCAT -> TATTTCAGAATAAACCATT
CGTTTTCAAGGAGGGATAC -> GTTTTCAAGGAGGGATACT
TGGACGGAACTAAAACCGC -> GGACGGAACTAAAACCGCG
GGTCTAGGAACAGACATAC -> GTCTAGGAACAGACATACA
CGGCCTGGGCGCAGCTAAG -> GGCCTGGGCGCAGCTAAGG
CCGACTCCCGCATAGACGT -> CGACTCCCGCATAGACGTT
GCAGTGTCGGTCTCGAGGA -> CAGTGTCGGTCTCGAGGAT
GCTAGTCTACGCTGTTAAC -> CTAGTCTACGCTGTTAACA
CGGTGTGTATATAAGCGGG -> GGTGTGTATATAAGCGGGT
TGCGGGCTCACACGTTCGA -> GCGGGCTCACACGTTCGAG
GACGGAACTAAAACCGCGA -> ACGGAACTAAAACCGCGAG
CCCAGCGTTAAGACAAACC -> CCAGCGTTAAGACAAACCG
TACTGGTGCCTCTTTACAA -> ACTGGTGCCTCTTTACAAT
GATGCGAGAGTGCACCTCC -> ATGCGAGAGTGCACCTCCA
TGCGCCTCGATAATGTTTC -> GCGCCTCGATAATGTTTCT
GGTATTTAAAGTATGGGAC -> GTATTTAAAGTATGGGACC
ATGTCCCGTTCTCATGAAT -> TGTCCCGTTCTCATGAATG
TTTACAGCAACATGACCTG -> TTACAGCAACATGACCTGC
AACCCTCCAGTATTGTCAG -> ACCCTCCAGTATTGTCAGA
AGAGCGTTAGCCCTTCAAA -> GAGCGTTAGCCCTTCAAAC
GGCATCCTTAGAGGTATTC -> GCATCCTTAGAGGTATTCA
CAGATTCGACCGCATCTTT -> AGATTCGACCGCATCTTTT
TGCTTCCTTAGAGGTATTC -> GCTTCCTTAGAGGTATTCA
GTGAAACCGATTCCCTAGC -> TGAAACCGATTCCCTAGCA
ATAGAAGCCAAAACAGGTT -> TAGAAGCCAAAACAGGTTG
TTAGGCGATGTGACTCTTC -> TAGGCGATGTGACTCTTCT
CGGCCCAGCCCTAATAGTA -> GGCCCAGCCCTAATAGTAG
CATACATGAGCCGTTTCAG -> ATACATGAGCCGTTTCAGT
AGCTGTAGTAAGCTATGAC -> GCTGTAGTAAGCTATGACA
TCGCCCTAATAGTAGTTCC -> CGCCCTAATAGTAGTTCCG
GTTTTCAAGGAGGGATACT -> TTTTCAAGGAGGGATACTG
TGGCGATCGGTGGAGGAGC -> GGCGATCGGTGGAGGAGCA
GTTCTTTTTATTCCATAAA -> TTCTTTTTATTCCATAAAC
GATGTGATGAGACGTTCTT -> ATGTGATGAGACGTTCTTT
CTGGCTTTTCTCGATCAGA -> TGGCTTTTCTCGATCAGAT
GGGGGCCGTAGCAAGCATA -> GGGGCCGTAGCAAGCATAG
CTGTACTATCTGAACTTCA -> TGTACTATCTGAACTTCAC
GAATAAACCATTTTGATGA -> AATAAACCATTTTGATGAA
CGTTCTCATGAATGTGCCC -> GTTCTCATGAATGTGCCCT
GGGCGCTAGTCTACGCTGT -> GGCGCTAGTCTACGCTGTT
TCAACTGAGGTTGGCGATA -> CAACTGAGGTTGGCGATAA
TAAACAGGTTAAAGGGTAG -> AAACAGGTTAAAGGGTAGG
TGCAATCCACTTTACCGTG -> GCAATCCACTTTACCGTGT
CGGATGATATGGGCCTAAC -> GGATGATATGGGCCTAACA
AAAGTTTAAGCATGAAGTA -> AAGTTTAAGCATGAAGTAT
TAGTTTATTGGATATACTT -> AGTTTATTGGATATACTTG
GAAAACCAACACTAACCCT -> AAAACCAACACTAACCCTC
CAGAAAAGCGGCCCAGCCC -> AGAAAAGCGGCCCAGCCCT
ATTTAAAGTATGGGACCGC -> TTTAAAGTATGGGACCGCT
ATGCCGCACCAGAACCATA -> TGCCGCACCAGAACCATAA
TGCACTAGCCCAGCGTTAA -> GCACTAGCCCAGCGTTAAG
AAGGAAAACCAACACTAAC -> AGGAAAACCAACACTAACC
CTGCGCAGCAACCACTCCG -> TGCGCAGCAACCACTCCGG
CGTGTCGCGCTTGTACGTG -> GTGTCGCGCTTGTACGTGG
ATCGTTTAACATACGCCTT -> TCGTTTAACATACGCCTTG
TGAACATAGACTATATCCG -> GAACATAGACTATATCCGT
CGCACTAACCCCCAGCCGG -> GCACTAACCCCCAGCCGGA
AGCGTTAAGACAAACCGCA -> GCGTTAAGACAAACCGCAG
AGTATTGTCAGAAATAGAA -> GTATTGTCAGAAATAGAAG
TTCCTTAGAGGTATTCAGA -> TCCTTAGAGGTATTCAGAT
TTTCACAGGGGCCCCCGGA -> TTCACAGGGGCCCCCGGAT
AGAGGTATTCAGACGTCGT -> GAGGTATTCAGACGTCGTG
CTATGTAAACCGACTCCCG -> TATGTAAACCGACTCCCGC
TGGTGCCTCTTTACAATAG -> GGTGCCTCTTTACAATAGT
ATCCGAGACTTACTCGAGG -> TCCGAGACTTACTCGAGGT
CCTTCGACGGTGTGTATAT -> CTTCGACGGTGTGTATATA
GGAGGAGCACTGTTCCCTT -> GAGGAGCACTGTTCCCTTC
CGGGCTGTGCGACTTAGGC -> GGGCTGTGCGACTTAGGCG
TTTATGCGGTAACTGCGCA -> TTATGCGGTAACTGCGCAG
GCCCCGAGCGACCGGTGGC -> CCCCGAGCGACCGGTGGCC
CCAGCCGGAGGTGGTACCT -> CAGCCGGAGGTGGTACCTC
CGACTTAGGCGATGTGACT -> GACTTAGGCGATGTGACTC
GCAACCACTCCGGGCTGTG -> CAACCACTCCGGGCTGTGC
CAAACCGCAGCATACGCAA -> AAACCGCAGCATACGCAAT
CTTACAGCCTCTTGCAATC -> TTACAGCCTCTTGCAATCC
AGAAGCCAAAACAGGTTGC -> GAAGCCAAAACAGGTTGCG
CCGCAGCATACGCAATGCG -> CGCAGCATACGCAATGCGT
AGAATAATGGGGAGTTTGG -> GAATAATGGGGAGTTTGGA
AAATGTTAAATCATGTCCT -> AATGTTAAATCATGTCCTT
GGAAAATGTTAAATCATGT -> GAAAATGTTAAATCATGTC
GCGCCTCGATAATGTTTCT -> CGCCTCGATAATGTTTCTT
TAATAGTAGTTCCGGCCTG -> AATAGTAGTTCCGGCCTGG
GCATGAAGTATAGAGCGTT -> CATGAAGTATAGAGCGTTA
ACTAACCCTCCAGTATTGT -> CTAACCCTCCAGTATTGTC
TCGTAAAGTGGCCCGTGCG -> CGTAAAGTGGCCCGTGCGT
CCACCCGGCACTATGATTC -> CACCCGGCACTATGATTCC
GTGCGACTTAGGCGATGTG -> TGCGACTTAGGCGATGTGA
GATATGGGCCTAACAGTTC -> ATATGGGCCTAACAGTTCT
GTTTATTGGATATACTTGG -> TTTATTGGATATACTTGGG
TAAAAGTTTAAGCATGAAG -> AAAAGTTTAAGCATGAAGT
GTGGCCCGTGCGTGTCGTA -> TGGCCCGTGCGTGTCGTAT
CGTAGCAAGCATAGCTGTA -> GTAGCAAGCATAGCTGTAG
TTCCAAATTGTTCGCAAGA -> TCCAAATTGTTCGCAAGAC
GGTGCGAGCCCTAATAGTA -> GTGCGAGCCCTAATAGTAG
TATGTAAACCGACTCCCGC -> ATGTAAACCGACTCCCGCA
TATACGCCGAAATGCCGCA -> ATACGCCGAAATGCCGCAC
AAAACCTCAACTACCGCAA -> AAACCTCAACTACCGCAAC
CCGCACCAGAACCATAAAA -> CGCACCAGAACCATAAAAG
CAGTTTGTCACATTGGCTG -> AGTTTGTCACATTGGCTGT
TAGACTTACAGCCTCTTGC -> AGACTTACAGCCTCTTGCA
TCCTTAGTTGTCGATGTGA -> CCTTAGTTGTCGATGTGAT
GTTAGAATAATGTAGCGTG -> TTAGAATAATGTAGCGTGT
CGCGAGGAAAATGTTAAAT -> GCGAGGAAAATGTTAAATC
CCGCTCTCAGCTGCCGAAA -> CGCTCTCAGCTGCCGAAAC
TAGTTGTCGATGTGATGAG -> AGTTGTCGATGTGATGAGA
CCCTATCAAATACTGAGGG -> CCTATCAAATACTGAGGGT
AGCGGGTCTAGGAACAGAC -> GCGGGTCTAGGAACAGACA
GTAGGTACGGCCTGGGACT -> TAGGTACGGCCTGGGACTG
GTCCTCAGTACAATTTTTA -> TCCTCAGTACAATTTTTAG
TTCACAGGGGCCCCCGGAT -> TCACAGGGGCCCCCGGATG
GAAACTTAGACGCCCTAAT -> AAACTTAGACGCCCTAATA
GCTCGGGACTTAGTTTGGA -> CTCGGGACTTAGTTTGGAA
ACAATTTATATGCGAGAGA -> CAATTTATATGCGAGAGAC
GCGTGACGCCCTATCAAAT -> CGTGACGCCCTATCAAATA
TCATTCGACATCGTCTTAC -> CATTCGACATCGTCTTACA
ACTTCACTGTCAGTCGAGT -> CTTCACTGTCAGTCGAGTG
GCGAGCCCTAATAGTAGTT -> CGAGCCCTAATAGTAGTTC
TTTCTTTCGACTACTACAC -> TTCTTTCGACTACTACACC
CCCTCGCAGATGAGGTGCC -> CCTCGCAGATGAGGTGCCG
AAACAGATTTACAGCAACA -> AACAGATTTACAGCAACAT
CCCGCATAGACGTTAACAA -> CCGCATAGACGTTAACAAT
TATCATAGCTACATTATTC -> ATCATAGCTACATTATTCG
GTTTCAGTGCAAGGTAATA -> TTTCAGTGCAAGGTAATAA
AAGTGCCAGTTTGTCACAT -> AGTGCCAGTTTGTCACATT
ACAGATTTACAGCAACATG -> CAGATTTACAGCAACATGA
ATCAAATACTGAGGGTATT -> TCAAATACTGAGGGTATTT
TCGATGTGATGAGACGTTC -> CGATGTGATGAGACGTTCT
GTTCTGGTTAGCTAATTGA -> TTCTGGTTAGCTAATTGAC
GACTTACAGCCTCTTGCAA -> ACTTACAGCCTCTTGCAAT
TGCATAGGCGTAGGTGAGG -> GCATAGGCGTAGGTGAGGC
TTGGGGGCCGTAGCAAGCA -> TGGGGGCCGTAGCAAGCAT
TGTTCGCAAGACGGTGCTT -> GTTCGCAAGACGGTGCTTC
TTCAGACGTCGTGAGTCGC -> TCAGACGTCGTGAGTCGCC
TAGTAGTTCCGGCCTGGGC -> AGTAGTTCCGGCCTGGGCG
GTCTATCATAGCTACATTA -> TCTATCATAGCTACATTAT
GACATTTGCCTTGAAAAAT -> ACATTTGCCTTGAAAAATA
GTTCCGTTTTCAAGGAGGG -> TTCCGTTTTCAAGGAGGGA
AGTTTGGACTATATACGCC -> GTTTGGACTATATACGCCG
GACGTTCTTTTTATTCCAT -> ACGTTCTTTTTATTCCATA
TGGATGCCTGCCTCTGCCA -> GGATGCCTGCCTCTGCCAC
CAACATAACCGGTCAACGT -> AACATAACCGGTCAACGTG
CCGCAGTTTAGAACTGATG -> CGCAGTTTAGAACTGATGT
GCCCTATCAAATACTGAGG -> CCCTATCAAATACTGAGGG
TAGAGGTATTCAGACGTCG -> AGAGGTATTCAGACGTCGT
TATCTGAACTTCACTGTCA -> ATCTGAACTTCACTGTCAG
CAGAACGCAGCAACATAAC -> AGAACGCAGCAACATAACC
GAACTGATGTATAGTCATT -> AACTGATGTATAGTCATTC
AAAATAAGACTCGCACTAA -> AAATAAGACTCGCACTAAC
GAGGTTGGCGATAAACAGG -> AGGTTGGCGATAAACAGGT
GTAAAGTGGCCCGTGCGTG -> TAAAGTGGCCCGTGCGTGT
AAGCTTGTTGTAAAAGTTT -> AGCTTGTTGTAAAAGTTTA
CACAGGGGCCCCCGGATGA -> ACAGGGGCCCCCGGATGAT
ATCATAGAGTTATTGTCGT -> TCATAGAGTTATTGTCGTT
CCAAAGCTTGTTGTAAAAG -> CAAAGCTTGTTGTAAAAGT
CCTCACTGTAACCATGTCT -> CTCACTGTAACCATGTCTA
ACGGCCTGGGACTGCTAGG -> CGGCCTGGGACTGCTAGGT
ACGCCCTAATAGTAGTTCC -> CGCCCTAATAGTAGTTCCG
CGAGATGCACTAGCCCAGC -> GAGATGCACTAGCCCAGCG
AGTTTAAGCATGAAGTATA -> GTTTAAGCATGAAGTATAG
ATTCTTTCCTCCTTAGAGG -> TTCTTTCCTCCTTAGAGGT
TGCGAGCCCTAATAGTAGT -> GCGAGCCCTAATAGTAGTT
CCCCCGGATGATATGGGCC -> CCCCGGATGATATGGGCCT
GCAGACTTATTTCGACAGA -> CAGACTTATTTCGACAGAT
TCGAGGTAGGGCGCTAGTC -> CGAGGTAGGGCGCTAGTCT
GCCTCTGCCACCCGGCACT -> CCTCTGCCACCCGGCACTA
GTTTTGTAATTAACACCAT -> TTTTGTAATTAACACCATT
GGACTTAGTTTGGAACCCA -> GACTTAGTTTGGAACCCAC
AAAGCTTGTTGTAAAAGTT -> AAGCTTGTTGTAAAAGTTT
CAGTTTAGAACTGATGTAT -> AGTTTAGAACTGATGTATA
AGACGCCCTAATAGTAGTT -> GACGCCCTAATAGTAGTTC
CCCCCGTGCACGAATCCGA -> CCCCGTGCACGAATCCGAG
AATTTTCTGTACCAACAAC -> ATTTTCTGTACCAACAACA
GCCCAGCCCTAATAGTAGT -> CCCAGCCCTAATAGTAGTT
ATTTACAGCAACATGACCT -> TTTACAGCAACATGACCTG
CGCCTGCCCAAAGCTTGTT -> GCCTGCCCAAAGCTTGTTG
GGCTGTGCGACTTAGGCGA -> GCTGTGCGACTTAGGCGAT
TCGATCAGATGCACGTGAC -> CGATCAGATGCACGTGACA
CCTCCAACCTGCAGATGTT -> CTCCAACCTGCAGATGTTG
GCTGCCGAAACGAATGTGA -> CTGCCGAAACGAATGTGAT
AAAAAAACCTCAACTACCG -> AAAAAACCTCAACTACCGC
GCCTCGATAATGTTTCTTT -> CCTCGATAATGTTTCTTTC
AGCGGCCCAGCCCTAATAG -> GCGGCCCAGCCCTAATAGT
TCAGATGGGGGTGCGAGCC -> CAGATGGGGGTGCGAGCCC
GAGGTATTCAGAGAAACTT -> AGGTATTCAGAGAAACTTA
GTTAAATCATGTCCTTAGT -> TTAAATCATGTCCTTAGTT
TCAGAAAAGCGGCCCAGCC -> CAGAAAAGCGGCCCAGCCC
TAACAATTTATATGCGAGA -> AACAATTTATATGCGAGAG
CTCAGCTGCCGAAACGAAT -> TCAGCTGCCGAAACGAATG
TAGAGGTATTCAGAGAAAC -> AGAGGTATTCAGAGAAACT
AAGTCGCCTGCAGAATAAT -> AGTCGCCTGCAGAATAATG
GTTTGGAACCCACGCCGCA -> TTTGGAACCCACGCCGCAG
TGCCTCTGCCACCCGGCAC -> GCCTCTGCCACCCGGCACT
CAGCAACCACTCCGGGCTG -> AGCAACCACTCCGGGCTGT
ACATACATGAGCCGTTTCA -> CATACATGAGCCGTTTCAG
GATGCACTAGCCCAGCGTT -> ATGCACTAGCCCAGCGTTA
AAAGTATGGGACCGCTCTC -> AAGTATGGGACCGCTCTCA
GACTACTACACCGGCAATC -> ACTACTACACCGGCAATCA
GCACTAACCCCCAGCCGGA -> CACTAACCCCCAGCCGGAG
GGCCTGGGACTGCTAGGTT -> GCCTGGGACTGCTAGGTTT
ACTTACTCGAGGTAGGGCG -> CTTACTCGAGGTAGGGCGC
CGGTCTCGAGGATGCGCGT -> GGTCTCGAGGATGCGCGTG
AGGAGGGATACTGGTGCCT -> GGAGGGATACTGGTGCCTC
ACATTATTCGCTGGTGAAC -> CATTATTCGCTGGTGAACA
ATTGGACGGAACTAAAACC -> TTGGACGGAACTAAAACCG
CAGATGTTGGTAGAAGTCG -> AGATGTTGGTAGAAGTCGC
AGGTTGCGGAAAAAAACCT -> GGTTGCGGAAAAAAACCTC
TAATAGTAGTTCCGGTTTC -> AATAGTAGTTCCGGTTTCA
ATGAATTACATCGTTTAAC -> TGAATTACATCGTTTAACA
TTTGCCTTGAAAAATAAGA -> TTGCCTTGAAAAATAAGAC
ACGCCTTGCTCGGGACTTA -> CGCCTTGCTCGGGACTTAG
CTTAGGCGATGTGACTCTT -> TTAGGCGATGTGACTCTTC
TTGTAAAAGTTTAAGCATG -> TGTAAAAGTTTAAGCATGA
CGCAGCATACGCAATGCGT -> GCAGCATACGCAATGCGTA
AGCCCTTCAAACCCTTAAT -> GCCCTTCAAACCCTTAATT
CCGCATCATAGAGTTATTG -> CGCATCATAGAGTTATTGT
CGCAGTTTAGAACTGATGT -> GCAGTTTAGAACTGATGTA
AGCGTGTAGCAGACTTATT -> GCGTGTAGCAGACTTATTT
GTCATTCGACATCGTCTTA -> TCATTCGACATCGTCTTAC
AATGCCGCACCAGAACCAT -> ATGCCGCACCAGAACCATA
ACAGTTCTGGTTAGCTAAT -> CAGTTCTGGTTAGCTAATT
AACTGCGGTGAGTTTCGTC -> ACTGCGGTGAGTTTCGTCA
AGGATGCGCGTGACGCCCT -> GGATGCGCGTGACGCCCTA
CAGTTCTGGTTAGCTAATT -> AGTTCTGGTTAGCTAATTG
CCGCATAGACGTTAACAAT -> CGCATAGACGTTAACAATT
GCTTGTTGTAAAAGTTTAA -> CTTGTTGTAAAAGTTTAAG
AGTTTCGTCAACTGAGGTT -> GTTTCGTCAACTGAGGTTG
ACTGCAGTGTCGGTCTCGA -> CTGCAGTGTCGGTCTCGAG
AAACCTCAACTACCGCAAC -> AACCTCAACTACCGCAACT
CTTAGACGCCCTAATAGTA -> TTAGACGCCCTAATAGTAG
ACTTTACCGTGTGAAACCG -> CTTTACCGTGTGAAACCGA
CAGATGCACGTGACAAACA -> AGATGCACGTGACAAACAG
CACTGTCAGTCGAGTGGTT -> ACTGTCAGTCGAGTGGTTA
GACTGCTAGGTTTTGTAAT -> ACTGCTAGGTTTTGTAATT
TTAGAGGTATTCAGATGGG -> TAGAGGTATTCAGATGGGG
GAAGCCAAAACAGGTTGCG -> AAGCCAAAACAGGTTGCGG
ACTTAGTTTGGAACCCACG -> CTTAGTTTGGAACCCACGC
ACCTTCTGTGCCCCCGTGC -> CCTTCTGTGCCCCCGTGCA
CACCTCCAACCTGCAGATG -> ACCTCCAACCTGCAGATGT
ACTTAGGCGATGTGACTCT -> CTTAGGCGATGTGACTCTT
ATTTTGATGAATTACATCG -> TTTTGATGAATTACATCGT
GGCGATCGGTGGAGGAGCA -> GCGATCGGTGGAGGAGCAC
GACTTATTTCGACAGATTC -> ACTTATTTCGACAGATTCG
TATCCGTGCGCCGAGTGGC -> ATCCGTGCGCCGAGTGGCG
GTTCTCATGAATGTGCCCT -> TTCTCATGAATGTGCCCTG
TGTTCCGTTTTCAAGGAGG -> GTTCCGTTTTCAAGGAGGG
AATGTCCCGTTCTCATGAA -> ATGTCCCGTTCTCATGAAT
ATAGACTATATCCGTGCGC -> TAGACTATATCCGTGCGCC
TCGAGGATGCGCGTGACGC -> CGAGGATGCGCGTGACGCC
TAAGTGCCAGTTTGTCACA -> AAGTGCCAGTTTGTCACAT
GAGCGTTAGCCCTTCAAAC -> AGCGTTAGCCCTTCAAACC
CGTGTAGCAGACTTATTTC -> GTGTAGCAGACTTATTTCG
GACTCCCGCATAGACGTTA -> ACTCCCGCATAGACGTTAA
GACGCCCTAATAGTAGTTC -> ACGCCCTAATAGTAGTTCC
GTCCCGTTCTCATGAATGT -> TCCCGTTCTCATGAATGTG
AACTACCGCAACTGCGGTG -> ACTACCGCAACTGCGGTGA
GAAATAGAAGCCAAAACAG -> AAATAGAAGCCAAAACAGG
GGTAGGGCGCTAGTCTACG -> GTAGGGCGCTAGTCTACGC
CCTTAGAGGTATTCAGATG -> CTTAGAGGTATTCAGATGG
AGAGGTATTCAGAGAAACT -> GAGGTATTCAGAGAAACTT
TAGACGCCCTAATAGTAGT -> AGACGCCCTAATAGTAGTT
TCCGCCGCATCATAGAGTT -> CCGCCGCATCATAGAGTTA
TGGGACTGCTAGGTTTTGT -> GGGACTGCTAGGTTTTGTA
CTTTACCGTGTGAAACCGA -> TTTACCGTGTGAAACCGAT
TATCGTACGCTGTACTCGT -> ATCGTACGCTGTACTCGTG
TCTTTCGACTACTACACCG -> CTTTCGACTACTACACCGG
TAATTTTCTGTACCAACAA -> AATTTTCTGTACCAACAAC
ACGCCTGCCCAAAGCTTGT -> CGCCTGCCCAAAGCTTGTT
CCCGGATGATATGGGCCTA -> CCGGATGATATGGGCCTAA
TAGAATAATGTAGCGTGTA -> AGAATAATGTAGCGTGTAG
TGCACGTGACAAACAGGTT -> GCACGTGACAAACAGGTTG
CGCTGGTGAACATAGACTA -> GCTGGTGAACATAGACTAT
CGATTCCCTAGCATCCGAG -> GATTCCCTAGCATCCGAGG
ACCCCCAGCCGGAGGTGGT -> CCCCCAGCCGGAGGTGGTA
CAGTGCAAGGTAATAAGTG -> AGTGCAAGGTAATAAGTGC
AGCCGTTTCAGTGCAAGGT -> GCCGTTTCAGTGCAAGGTA
TAGCCCTTCAAACCCTTAA -> AGCCCTTCAAACCCTTAAT
GACGGTGCTTCCTTAGAGG -> ACGGTGCTTCCTTAGAGGT
CCGGCAATCATCCGCCGCA -> CGGCAATCATCCGCCGCAT
ACCGATTCCCTAGCATCCG -> CCGATTCCCTAGCATCCGA
ATCGTCTTACATATCGTAA -> TCGTCTTACATATCGTAAA
TTAAGACAAACCGCAGCAT -> TAAGACAAACCGCAGCATA
GTGAACATAGACTATATCC -> TGAACATAGACTATATCCG
CTCCAGTATTGTCAGAAAT -> TCCAGTATTGTCAGAAATA
AAGCGTGGAATGTAATATA -> AGCGTGGAATGTAATATAC
ATAGGTACTGCAGTGTCGG -> TAGGTACTGCAGTGTCGGT
AAACAGGTTAAAGGGTAGG -> AACAGGTTAAAGGGTAGGT
CCGATTCCCTAGCATCCGA -> CGATTCCCTAGCATCCGAG
CAGCTGCCGAAACGAATGT -> AGCTGCCGAAACGAATGTG
GTCAACTGCGCCTCGATAA -> TCAACTGCGCCTCGATAAT
TAAGCTATGACACGCAGAA -> AAGCTATGACACGCAGAAC
CTCCCGCATAGACGTTAAC -> TCCCGCATAGACGTTAACA
TTTACAATAGTTAGAATAA -> TTACAATAGTTAGAATAAT
ATAACCGGTCAACGTGCCC -> TAACCGGTCAACGTGCCCT
GATTCGACCGCATCTTTTT -> ATTCGACCGCATCTTTTTT
CGAAACGAATGTGATACGC -> GAAACGAATGTGATACGCC
TCATCCGCCGCATCATAGA -> CATCCGCCGCATCATAGAG
TTAACATACGCCTTGCTCG -> TAACATACGCCTTGCTCGG
TAGCGGAAGCGTGGAATGT -> AGCGGAAGCGTGGAATGTA
GGCACTATGATTCCAAATT -> GCACTATGATTCCAAATTG
TAAGGTCCTCAGTACAATT -> AAGGTCCTCAGTACAATTT
GGACGGAACTAAAACCGCG -> GACGGAACTAAAACCGCGA
TTTGTCACATTGGCTGTGC -> TTGTCACATTGGCTGTGCT
TGGTCCTTAGAGGTATTCA -> GGTCCTTAGAGGTATTCAG
TGAAACCGATTCCCTAGCA -> GAAACCGATTCCCTAGCAT
AAACAGGTTGCGGAAAAAA -> AACAGGTTGCGGAAAAAAA
CTTAGTTGTCGATGTGATG -> TTAGTTGTCGATGTGATGA
CTATCAAATACTGAGGGTA -> TATCAAATACTGAGGGTAT
ACATGAGCCGTTTCAGTGC -> CATGAGCCGTTTCAGTGCA
TCACAGGGGCCCCCGGATG -> CACAGGGGCCCCCGGATGA
TTGACCTTCTGTGCCCCCG -> TGACCTTCTGTGCCCCCGT
ATTGACATTTGCCTTGAAA -> TTGACATTTGCCTTGAAAA
GGTGCTTCCTTAGAGGTAT -> GTGCTTCCTTAGAGGTATT
TTCAAACCCTTAATTTTCT -> TCAAACCCTTAATTTTCTG
ATTTCGACAGATTCGACCG -> TTTCGACAGATTCGACCGC
AGGAACAGACATACATGAG -> GGAACAGACATACATGAGC
AGAGGTATTCAGAAAAGCG -> GAGGTATTCAGAAAAGCGG
CCATAAACAGATTTACAGC -> CATAAACAGATTTACAGCA
AATTTTTAGCCCATTATTG -> ATTTTTAGCCCATTATTGT
ACTTAGACGCCCTAATAGT -> CTTAGACGCCCTAATAGTA
CGCTGTACTCGTGTCGCGC -> GCTGTACTCGTGTCGCGCT
CACTAACCCTCCAGTATTG -> ACTAACCCTCCAGTATTGT
TTAGAATAATGTAGCGTGT -> TAGAATAATGTAGCGTGTA
GGATATACTTGGGTGCATT -> GATATACTTGGGTGCATTT
AACAATTTATATGCGAGAG -> ACAATTTATATGCGAGAGA
CCCACGCCGCAGTTTAGAA -> CCACGCCGCAGTTTAGAAC
AAAAGCGGCCCAGCCCTAA -> AAAGCGGCCCAGCCCTAAT
AAGGTAATAAGTGCCAGTT -> AGGTAATAAGTGCCAGTTT
GGATGATATGGGCCTAACA -> GATGATATGGGCCTAACAG
ATAGAGTTATTGTCGTTAG -> TAGAGTTATTGTCGTTAGT
GCGCAGCTAAGGTCCTCAG -> CGCAGCTAAGGTCCTCAGT
TTTTGATGAATTACATCGT -> TTTGATGAATTACATCGTT
CCTCTTGCAATCCACTTTA -> CTCTTGCAATCCACTTTAC
TGCAGTGTCGGTCTCGAGG -> GCAGTGTCGGTCTCGAGGA
GCAACTGCGGTGAGTTTCG -> CAACTGCGGTGAGTTTCGT
TCGCCTGCAGAATAATGGG -> CGCCTGCAGAATAATGGGG
GGAAAACCAACACTAACCC -> GAAAACCAACACTAACCCT
TTATTGGATATACTTGGGT -> TATTGGATATACTTGGGTG
ACTATATCCGTGCGCCGAG -> CTATATCCGTGCGCCGAGT
ATTTTCTGTACCAACAACA -> TTTTCTGTACCAACAACAG
CTTACATATCGTAAAGTGG -> TTACATATCGTAAAGTGGC
AGTGTCAACTGCGCCTCGA -> GTGTCAACTGCGCCTCGAT
AAACCGCAGCATACGCAAT -> AACCGCAGCATACGCAATG
TCATAGCTACATTATTCGC -> CATAGCTACATTATTCGCT
AATAGTAGTTCCGGTTTCA -> ATAGTAGTTCCGGTTTCAC
GATGGGGGTGCGAGCCCTA -> ATGGGGGTGCGAGCCCTAA
ATCCGTGCGCCGAGTGGCG -> TCCGTGCGCCGAGTGGCGA
AGATGAGGTGCCGGATGCG -> GATGAGGTGCCGGATGCGA
ACATTGGCTGTGCTTGACC -> CATTGGCTGTGCTTGACCT
CATAGACTATATCCGTGCG -> ATAGACTATATCCGTGCGC
CCTCAGTACAATTTTTAGC -> CTCAGTACAATTTTTAGCC
TTAGCCCATTATTGTTCCG -> TAGCCCATTATTGTTCCGT
CAAAGCTTGTTGTAAAAGT -> AAAGCTTGTTGTAAAAGTT
TGTCAGAAATAGAAGCCAA -> GTCAGAAATAGAAGCCAAA
CGTGGAATGTAATATACAG -> GTGGAATGTAATATACAGA
ATAGTAGTTCCGGTTTCAC -> TAGTAGTTCCGGTTTCACA
ATGTTGGTAGAAGTCGCCT -> TGTTGGTAGAAGTCGCCTG
TAGTAGTTCCGGTTGGGTG -> AGTAGTTCCGGTTGGGTGC
GTGAGTTTCGTCAACTGAG -> TGAGTTTCGTCAACTGAGG
TGCCCCCGTGCACGAATCC -> GCCCCCGTGCACGAATCCG
TTCACTGTCAGTCGAGTGG -> TCACTGTCAGTCGAGTGGT
CACGTGACAAACAGGTTGG -> ACGTGACAAACAGGTTGGG
AAAGGAAAACCAACACTAA -> AAGGAAAACCAACACTAAC
TTAACACCATTCGATTGGA -> TAACACCATTCGATTGGAC
CAACATGACCTGCGGGCTC -> AACATGACCTGCGGGCTCA
CGACATCGTCTTACATATC -> GACATCGTCTTACATATCG
TTGGAACCCACGCCGCAGT -> TGGAACCCACGCCGCAGTT
CCCAGCCCTAATAGTAGTT -> CCAGCCCTAATAGTAGTTC
AACCAACACTAACCCTCCA -> ACCAACACTAACCCTCCAG
AAAAAACCTCAACTACCGC -> AAAAACCTCAACTACCGCA
GTTTCTTTCGACTACTACA -> TTTCTTTCGACTACTACAC
AGTTGTCGATGTGATGAGA -> GTTGTCGATGTGATGAGAC
TTTGGACTATATACGCCGA -> TTGGACTATATACGCCGAA
AGCTATGACACGCAGAACG -> GCTATGACACGCAGAACGC
GCACGTGACAAACAGGTTG -> CACGTGACAAACAGGTTGG
ATCATCCGCCGCATCATAG -> TCATCCGCCGCATCATAGA
CGTCGTGAGTCGCCCTAAT -> GTCGTGAGTCGCCCTAATA
GTATAGAGCGTTAGCCCTT -> TATAGAGCGTTAGCCCTTC
CATAGAGTTATTGTCGTTA -> ATAGAGTTATTGTCGTTAG
AAGTTTAAGCATGAAGTAT -> AGTTTAAGCATGAAGTATA
GCACCAGAACCATAAAAGG -> CACCAGAACCATAAAAGGA
CTAATAGTAGTTCCGGTTG -> TAATAGTAGTTCCGGTTGG
AGTAAGCTATGACACGCAG -> GTAAGCTATGACACGCAGA
GTTTGTCACATTGGCTGTG -> TTTGTCACATTGGCTGTGC
TACAGCAACATGACCTGCG -> ACAGCAACATGACCTGCGG
ACGCCGCAGTTTAGAACTG -> CGCCGCAGTTTAGAACTGA
TACTATCTGAACTTCACTG -> ACTATCTGAACTTCACTGT
CCCATTATTGTTCCGTTTT -> CCATTATTGTTCCGTTTTC
AAAAATAAGACTCGCACTA -> AAAATAAGACTCGCACTAA
AGGCATCCTTAGAGGTATT -> GGCATCCTTAGAGGTATTC
AGTGGTTAAACTAGACTTA -> GTGGTTAAACTAGACTTAC
ACCGGCAATCATCCGCCGC -> CCGGCAATCATCCGCCGCA
AGCTGCCGAAACGAATGTG -> GCTGCCGAAACGAATGTGA
CGTTAGCCCTTCAAACCCT -> GTTAGCCCTTCAAACCCTT
TTAAACTAGACTTACAGCC -> TAAACTAGACTTACAGCCT
CCTTAGAGGTATTCAGAGA -> CTTAGAGGTATTCAGAGAA
AAACGAATGTGATACGCCT -> AACGAATGTGATACGCCTG
TGCGCGTGACGCCCTATCA -> GCGCGTGACGCCCTATCAA
CTGCCCAAAGCTTGTTGTA -> TGCCCAAAGCTTGTTGTAA
TAGTAGTTCCGGTTTCACA -> AGTAGTTCCGGTTTCACAG
TAGCTAATTGACATTTGCC -> AGCTAATTGACATTTGCCT
ACTGAGGGTATTTAAAGTA -> CTGAGGGTATTTAAAGTAT
AACAGGTTAAAGGGTAGGT -> ACAGGTTAAAGGGTAGGTA
TGTTCCCTTCGACGGTGTG -> GTTCCCTTCGACGGTGTGT
GAAAATGTTAAATCATGTC -> AAAATGTTAAATCATGTCC
GTTAAAGGGTAGGTACGGC -> TTAAAGGGTAGGTACGGCC
AAACAGGTTGGGGGCCGTA -> AACAGGTTGGGGGCCGTAG
GCAGTTTAGAACTGATGTA -> CAGTTTAGAACTGATGTAT
CAGACTTATTTCGACAGAT -> AGACTTATTTCGACAGATT
TATGCGAGAGACAATTCTT -> ATGCGAGAGACAATTCTTT
ATTGGCTGTGCTTGACCTT -> TTGGCTGTGCTTGACCTTC
ATGACCTGCGGGCTCACAC -> TGACCTGCGGGCTCACACG
AGAACCATAAAAGGAAAAC -> GAACCATAAAAGGAAAACC
GAGTTATTGTCGTTAGTTT -> AGTTATTGTCGTTAGTTTA
TACCTCACTGTAACCATGT -> ACCTCACTGTAACCATGTC
AAGCTATGACACGCAGAAC -> AGCTATGACACGCAGAACG
GATACTGGTGCCTCTTTAC -> ATACTGGTGCCTCTTTACA
ACAGATTCGACCGCATCTT -> CAGATTCGACCGCATCTTT
TCAGACGTCGTGAGTCGCC -> CAGACGTCGTGAGTCGCCC
TGTCCTTAGTTGTCGATGT -> GTCCTTAGTTGTCGATGTG
TTATATGCGAGAGACAATT -> TATATGCGAGAGACAATTC
ACTGGGAACTGTACTATCT -> CTGGGAACTGTACTATCTG
TAATATACAGAGGTTAAGT -> AATATACAGAGGTTAAGTG
AATCCACTTTACCGTGTGA -> ATCCACTTTACCGTGTGAA
AGCATCCGAGGCATCCTTA -> GCATCCGAGGCATCCTTAG
AAAAGGAAAACCAACACTA -> AAAGGAAAACCAACACTAA
CTACTACACCGGCAATCAT -> TACTACACCGGCAATCATC
AGATTTACAGCAACATGAC -> GATTTACAGCAACATGACC
TACTACACCGGCAATCATC -> ACTACACCGGCAATCATCC
TTATTCCATAAACAGATTT -> TATTCCATAAACAGATTTA
CACTGTTCCCTTCGACGGT -> ACTGTTCCCTTCGACGGTG
ACAGTTAGCGGAAGCGTGG -> CAGTTAGCGGAAGCGTGGA
TCACATTGGCTGTGCTTGA -> CACATTGGCTGTGCTTGAC
TAGCGTGTAGCAGACTTAT -> AGCGTGTAGCAGACTTATT
GAGACTTACTCGAGGTAGG -> AGACTTACTCGAGGTAGGG
GGCGATGTGACTCTTCTCC -> GCGATGTGACTCTTCTCCT
GCTACATTATTCGCTGGTG -> CTACATTATTCGCTGGTGA
TGATGAATTACATCGTTTA -> GATGAATTACATCGTTTAA
CTCCGGGCTGTGCGACTTA -> TCCGGGCTGTGCGACTTAG
GGCCCGTGCGTGTCGTATA -> GCCCGTGCGTGTCGTATAG
GTATAGGTACTGCAGTGTC -> TATAGGTACTGCAGTGTCG
GTAGGTGAGGCACACAGGT -> TAGGTGAGGCACACAGGTT
TCCGGGCTGTGCGACTTAG -> CCGGGCTGTGCGACTTAGG
GGCTGTGCTTGACCTTCTG -> GCTGTGCTTGACCTTCTGT
CGGCGGGTATTTCAGAATA -> GGCGGGTATTTCAGAATAA
CGGGTCTAGGAACAGACAT -> GGGTCTAGGAACAGACATA
GTTAACACTTAGGAATGTC -> TTAACACTTAGGAATGTCC
ACCAACAACAGTTAGCGGA -> CCAACAACAGTTAGCGGAA
AGGGCGCTAGTCTACGCTG -> GGGCGCTAGTCTACGCTGT
TAGTTCCGGTTTCACAGGG -> AGTTCCGGTTTCACAGGGG
GTTGGGTGCCCCGAGCGAC -> TTGGGTGCCCCGAGCGACC
ATAAAAGGAAAACCAACAC -> TAAAAGGAAAACCAACACT
CTACGCTGTTAACACTTAG -> TACGCTGTTAACACTTAGG
TTATTTCGACAGATTCGAC -> TATTTCGACAGATTCGACC
GAACAGACATACATGAGCC -> AACAGACATACATGAGCCG
TTTATATGCGAGAGACAAT -> TTATATGCGAGAGACAATT
TAGTTAGAATAATGTAGCG -> AGTTAGAATAATGTAGCGT
GACCGCTCTCAGCTGCCGA -> ACCGCTCTCAGCTGCCGAA
CTTATTTCGACAGATTCGA -> TTATTTCGACAGATTCGAC
TAATAGTAGTTCCGGTTGG -> AATAGTAGTTCCGGTTGGG
TTAAAGTATGGGACCGCTC -> TAAAGTATGGGACCGCTCT
AGGAATGTCCCGTTCTCAT -> GGAATGTCCCGTTCTCATG
GCGATAAACAGGTTAAAGG -> CGATAAACAGGTTAAAGGG
ATATCGTACGCTGTACTCG -> TATCGTACGCTGTACTCGT
TACGCCGAAATGCCGCACC -> ACGCCGAAATGCCGCACCA
TCCAGTATTGTCAGAAATA -> CCAGTATTGTCAGAAATAG
CCACTTTACCGTGTGAAAC -> CACTTTACCGTGTGAAACC
ACCTGCAGATGTTGGTAGA -> CCTGCAGATGTTGGTAGAA
GAAAAGCGGCCCAGCCCTA -> AAAAGCGGCCCAGCCCTAA
GCACCTCCAACCTGCAGAT -> CACCTCCAACCTGCAGATG
CGGTTGGGTGCCCCGAGCG -> GGTTGGGTGCCCCGAGCGA
GAGGTGCCGGATGCGAGAG -> AGGTGCCGGATGCGAGAGT
AGGTATTCAGACGTCGTGA -> GGTATTCAGACGTCGTGAG
TTTAGCCCATTATTGTTCC -> TTAGCCCATTATTGTTCCG
TCGACTACTACACCGGCAA -> CGACTACTACACCGGCAAT
TGCGCAGCAACCACTCCGG -> GCGCAGCAACCACTCCGGG
CAATTTATATGCGAGAGAC -> AATTTATATGCGAGAGACA
GAATGTGATACGCCTGCCC -> AATGTGATACGCCTGCCCA
TCACTGTAACCATGTCTAT -> CACTGTAACCATGTCTATC
AGTCGCCTGCAGAATAATG -> GTCGCCTGCAGAATAATGG
GTGCCTCTTTACAATAGTT -> TGCCTCTTTACAATAGTTA
CACGAATCCGAGACTTACT -> ACGAATCCGAGACTTACTC
AGACTCGCACTAACCCCCA -> GACTCGCACTAACCCCCAG
CCTCCTTAGAGGTATTCAG -> CTCCTTAGAGGTATTCAGA
GTACAATTTTTAGCCCATT -> TACAATTTTTAGCCCATTA
AGATGTTGGTAGAAGTCGC -> GATGTTGGTAGAAGTCGCC
ACATATCGTAAAGTGGCCC -> CATATCGTAAAGTGGCCCG
ACTCGCACTAACCCCCAGC -> CTCGCACTAACCCCCAGCC
GTGTCGTATAGGTACTGCA -> TGTCGTATAGGTACTGCAG
TGAACTTCACTGTCAGTCG -> GAACTTCACTGTCAGTCGA
GGTGTGTATATAAGCGGGT -> GTGTGTATATAAGCGGGTC
GACTATATCCGTGCGCCGA -> ACTATATCCGTGCGCCGAG
AATCCGAGACTTACTCGAG -> ATCCGAGACTTACTCGAGG
GGTTGGCGATAAACAGGTT -> GTTGGCGATAAACAGGTTA
CCTGCGGGCTCACACGTTC -> CTGCGGGCTCACACGTTCG
TTTGGAACCCACGCCGCAG -> TTGGAACCCACGCCGCAGT
AGAGACAATTCTTTCCTCC -> GAGACAATTCTTTCCTCCT
GTTAGTTTATTGGATATAC -> TTAGTTTATTGGATATACT
CAGTGTCGGTCTCGAGGAT -> AGTGTCGGTCTCGAGGATG
GTACGGCCTGGGACTGCTA -> TACGGCCTGGGACTGCTAG
TTAGCTAATTGACATTTGC -> TAGCTAATTGACATTTGCC
CGGTGGAGGAGCACTGTTC -> GGTGGAGGAGCACTGTTCC
TCAAGGAGGGATACTGGTG -> CAAGGAGGGATACTGGTGC
CGGAAAAAAACCTCAACTA -> GGAAAAAAACCTCAACTAC
CTTTTTATTCCATAAACAG -> TTTTTATTCCATAAACAGA
AGGTGAGGCACACAGGTTA -> GGTGAGGCACACAGGTTAT
AGCTACATTATTCGCTGGT -> GCTACATTATTCGCTGGTG
ATATCGTAAAGTGGCCCGT -> TATCGTAAAGTGGCCCGTG
CGGTGGCCCTCGCAGATGA -> GGTGGCCCTCGCAGATGAG
ATCCACTTTACCGTGTGAA -> TCCACTTTACCGTGTGAAA
ACGTTAACAATTTATATGC -> CGTTAACAATTTATATGCG
ATATACAGAGGTTAAGTGT -> TATACAGAGGTTAAGTGTC
TCCGGCCTGGGCGCAGCTA -> CCGGCCTGGGCGCAGCTAA
CGCTAGTCTACGCTGTTAA -> GCTAGTCTACGCTGTTAAC
TTCGTCAACTGAGGTTGGC -> TCGTCAACTGAGGTTGGCG
CTATCTGAACTTCACTGTC -> TATCTGAACTTCACTGTCA
CGACCGCATCTTTTTTATG -> GACCGCATCTTTTTTATGC
GTAGTTCCGGCCTGGGCGC -> TAGTTCCGGCCTGGGCGCA
ACTCGAGGTAGGGCGCTAG -> CTCGAGGTAGGGCGCTAGT
GTGCAAGGTAATAAGTGCC -> TGCAAGGTAATAAGTGCCA
AGCTAATTGACATTTGCCT -> GCTAATTGACATTTGCCTT
TGCCACCCGGCACTATGAT -> GCCACCCGGCACTATGATT
AACTGCGCAGCAACCACTC -> ACTGCGCAGCAACCACTCC
TCAGAGAAACTTAGACGCC -> CAGAGAAACTTAGACGCCC
ATAGGCGTAGGTGAGGCAC -> TAGGCGTAGGTGAGGCACA
GCGTAGGTGAGGCACACAG -> CGTAGGTGAGGCACACAGG
ATTCCATAAACAGATTTAC -> TTCCATAAACAGATTTACA
GGTGAGTTTCGTCAACTGA -> GTGAGTTTCGTCAACTGAG
GGGCCTAACAGTTCTGGTT -> GGCCTAACAGTTCTGGTTA
CACTAACCCCCAGCCGGAG -> ACTAACCCCCAGCCGGAGG
CCTGGGACTGCTAGGTTTT -> CTGGGACTGCTAGGTTTTG
TGTCACATTGGCTGTGCTT -> GTCACATTGGCTGTGCTTG
TTAGTTTGGAACCCACGCC -> TAGTTTGGAACCCACGCCG
CCGGTTGGGTGCCCCGAGC -> CGGTTGGGTGCCCCGAGCG
GCGACCGGTGGCCCTCGCA -> CGACCGGTGGCCCTCGCAG
TCCCTTCGACGGTGTGTAT -> CCCTTCGACGGTGTGTATA
TTTTAGCCCATTATTGTTC -> TTTAGCCCATTATTGTTCC
CGTGAGTCGCCCTAATAGT -> GTGAGTCGCCCTAATAGTA
CGAAATGCCGCACCAGAAC -> GAAATGCCGCACCAGAACC
GGTTAAAGGGTAGGTACGG -> GTTAAAGGGTAGGTACGGC
ACACTTAGGAATGTCCCGT -> CACTTAGGAATGTCCCGTT
GTCGGTCTCGAGGATGCGC -> TCGGTCTCGAGGATGCGCG
ATAGACGTTAACAATTTAT -> TAGACGTTAACAATTTATA
CTGAACTTCACTGTCAGTC -> TGAACTTCACTGTCAGTCG
TAGTTCCGGCGGGTATTTC -> AGTTCCGGCGGGTATTTCA
GTACTGCAGTGTCGGTCTC -> TACTGCAGTGTCGGTCTCG
CGGAAGCGTGGAATGTAAT -> GGAAGCGTGGAATGTAATA
GAACCCACGCCGCAGTTTA -> AACCCACGCCGCAGTTTAG
CTATCATAGCTACATTATT -> TATCATAGCTACATTATTC
TAACCATGTCTATCATAGC -> AACCATGTCTATCATAGCT
GCCCTCGCAGATGAGGTGC -> CCCTCGCAGATGAGGTGCC
GATACGCCTGCCCAAAGCT -> ATACGCCTGCCCAAAGCTT
CACACGTTCGAGATGCACT -> ACACGTTCGAGATGCACTA
TAGGCGTAGGTGAGGCACA -> AGGCGTAGGTGAGGCACAC
TCGTCTTACATATCGTAAA -> CGTCTTACATATCGTAAAG
CGCCCTAATAGTAGTTCCG -> GCCCTAATAGTAGTTCCGG,GCCCTAATAGTAGTTCCGG
TAATGGGGAGTTTGGACTA -> AATGGGGAGTTTGGACTAT
GAGTGGCGATCGGTGGAGG -> AGTGGCGATCGGTGGAGGA
GTAAGCTATGACACGCAGA -> TAAGCTATGACACGCAGAA
ACCTCCAACCTGCAGATGT -> CCTCCAACCTGCAGATGTT
GAATCCGAGACTTACTCGA -> AATCCGAGACTTACTCGAG
CTGCGCCTCGATAATGTTT -> TGCGCCTCGATAATGTTTC
AACTGCGCCTCGATAATGT -> ACTGCGCCTCGATAATGTT
AACCTCAACTACCGCAACT -> ACCTCAACTACCGCAACTG
GTGTGTATATAAGCGGGTC -> TGTGTATATAAGCGGGTCT
ATAGTAGTTCCGGCGGGTA -> TAGTAGTTCCGGCGGGTAT
AGCAACATAACCGGTCAAC -> GCAACATAACCGGTCAACG
AGACTATATCCGTGCGCCG -> GACTATATCCGTGCGCCGA
ACATCGTCTTACATATCGT -> CATCGTCTTACATATCGTA
ACCAACACTAACCCTCCAG -> CCAACACTAACCCTCCAGT
TTAACACTTAGGAATGTCC -> TAACACTTAGGAATGTCCC
GGCGTAGGTGAGGCACACA -> GCGTAGGTGAGGCACACAG
TCGCGCTTGTACGTGGTCC -> CGCGCTTGTACGTGGTCCT
ATAAACCATTTTGATGAAT -> TAAACCATTTTGATGAATT
AGGTTAAGTGTCAACTGCG -> GGTTAAGTGTCAACTGCGC
TAGCAGACTTATTTCGACA -> AGCAGACTTATTTCGACAG
CCTAGCATCCGAGGCATCC -> CTAGCATCCGAGGCATCCT
CTCACTGTAACCATGTCTA -> TCACTGTAACCATGTCTAT
CAGAATAAACCATTTTGAT -> AGAATAAACCATTTTGATG
ACCCACGCCGCAGTTTAGA -> CCCACGCCGCAGTTTAGAA
TAGAAGTCGCCTGCAGAAT -> AGAAGTCGCCTGCAGAATA
CGATGTGACTCTTCTCCTT -> GATGTGACTCTTCTCCTTG
TGCCTTGAAAAATAAGACT -> GCCTTGAAAAATAAGACTC
CGTGACGCCCTATCAAATA -> GTGACGCCCTATCAAATAC
CTCTGCCACCCGGCACTAT -> TCTGCCACCCGGCACTATG
CATCGTTTAACATACGCCT -> ATCGTTTAACATACGCCTT
CCGCAACTGCGGTGAGTTT -> CGCAACTGCGGTGAGTTTC
AGATCACTGGGAACTGTAC -> GATCACTGGGAACTGTACT
TAAACTAGACTTACAGCCT -> AAACTAGACTTACAGCCTC
AGTTAGCGGAAGCGTGGAA -> GTTAGCGGAAGCGTGGAAT
CCCCGGATGATATGGGCCT -> CCCGGATGATATGGGCCTA
ACATAACCGGTCAACGTGC -> CATAACCGGTCAACGTGCC
TAAACCATTTTGATGAATT -> AAACCATTTTGATGAATTA
AACACCATTCGATTGGACG -> ACACCATTCGATTGGACGG
CGCTGTTAACACTTAGGAA -> GCTGTTAACACTTAGGAAT
ATGTGACTCTTCTCCTTGC -> TGTGACTCTTCTCCTTGCA
ACCGGTCAACGTGCCCTCT -> CCGGTCAACGTGCCCTCTA
GGTACGGCCTGGGACTGCT -> GTACGGCCTGGGACTGCTA
TCATGAATGTGCCCTGGCT -> CATGAATGTGCCCTGGCTT
CAATTTTTAGCCCATTATT -> AATTTTTAGCCCATTATTG
TGGCCCGTGCGTGTCGTAT -> GGCCCGTGCGTGTCGTATA
AAATTGTTCGCAAGACGGT -> AATTGTTCGCAAGACGGTG
ATTTTGGATGCCTGCCTCT -> TTTTGGATGCCTGCCTCTG
TTGAAAAATAAGACTCGCA -> TGAAAAATAAGACTCGCAC
GCGATGTGACTCTTCTCCT -> CGATGTGACTCTTCTCCTT
CAGTATTGTCAGAAATAGA -> AGTATTGTCAGAAATAGAA
TATATAAGCGGGTCTAGGA -> ATATAAGCGGGTCTAGGAA
CGAGAGACAATTCTTTCCT -> GAGAGACAATTCTTTCCTC
TTAAATCATGTCCTTAGTT -> TAAATCATGTCCTTAGTTG
GCATCATAGAGTTATTGTC -> CATCATAGAGTTATTGTCG
TCAGAATAAACCATTTTGA -> CAGAATAAACCATTTTGAT
TAGGAACAGACATACATGA -> AGGAACAGACATACATGAG
CATCCTTAGAGGTATTCAG -> ATCCTTAGAGGTATTCAGA
TGCCTGCCTCTGCCACCCG -> GCCTGCCTCTGCCACCCGG
GGACCGCTCTCAGCTGCCG -> GACCGCTCTCAGCTGCCGA
TCTTTTTATTCCATAAACA -> CTTTTTATTCCATAAACAG
TTGCCTTGAAAAATAAGAC -> TGCCTTGAAAAATAAGACT
CATGAAGTATAGAGCGTTA -> ATGAAGTATAGAGCGTTAG
TATGATTCCAAATTGTTCG -> ATGATTCCAAATTGTTCGC
CCTGCAGATGTTGGTAGAA -> CTGCAGATGTTGGTAGAAG
GCGGTAACTGCGCAGCAAC -> CGGTAACTGCGCAGCAACC
AATTCTTTCCTCCTTAGAG -> ATTCTTTCCTCCTTAGAGG
GTCGTTAGTTTATTGGATA -> TCGTTAGTTTATTGGATAT
AAGTATGGGACCGCTCTCA -> AGTATGGGACCGCTCTCAG
TAAGCATGAAGTATAGAGC -> AAGCATGAAGTATAGAGCG
GAGGATGCGCGTGACGCCC -> AGGATGCGCGTGACGCCCT
CGTTCGAGATGCACTAGCC -> GTTCGAGATGCACTAGCCC
GGTGCATTTTGGATGCCTG -> GTGCATTTTGGATGCCTGC
TAGAGCGTTAGCCCTTCAA -> AGAGCGTTAGCCCTTCAAA
TTGCAATCCACTTTACCGT -> TGCAATCCACTTTACCGTG
GCTGTAGTAAGCTATGACA -> CTGTAGTAAGCTATGACAC
AGCTTGTTGTAAAAGTTTA -> GCTTGTTGTAAAAGTTTAA
TTACCGTGTGAAACCGATT -> TACCGTGTGAAACCGATTC
TTCGACATCGTCTTACATA -> TCGACATCGTCTTACATAT
GTTGTAAAAGTTTAAGCAT -> TTGTAAAAGTTTAAGCATG
CGTAAAGTGGCCCGTGCGT -> GTAAAGTGGCCCGTGCGTG
ATGGGCCTAACAGTTCTGG -> TGGGCCTAACAGTTCTGGT
CAGAAATAGAAGCCAAAAC -> AGAAATAGAAGCCAAAACA
CGACTACTACACCGGCAAT -> GACTACTACACCGGCAATC
GCCCAAAGCTTGTTGTAAA -> CCCAAAGCTTGTTGTAAAA
GTCGTATAGGTACTGCAGT -> TCGTATAGGTACTGCAGTG
AATGCGTATTCATATCGTA -> ATGCGTATTCATATCGTAC
AGACTTATTTCGACAGATT -> GACTTATTTCGACAGATTC
GTTGCGGAAAAAAACCTCA -> TTGCGGAAAAAAACCTCAA
GACTTACTCGAGGTAGGGC -> ACTTACTCGAGGTAGGGCG
CAACTGCGGTGAGTTTCGT -> AACTGCGGTGAGTTTCGTC
AAAAGTTTAAGCATGAAGT -> AAAGTTTAAGCATGAAGTA
CGAGGCATCCTTAGAGGTA -> GAGGCATCCTTAGAGGTAT
AAAGCGGCCCAGCCCTAAT -> AAGCGGCCCAGCCCTAATA
CAAACAGGTTGGGGGCCGT -> AAACAGGTTGGGGGCCGTA
CGCTTGTACGTGGTCCTTA -> GCTTGTACGTGGTCCTTAG
TAGTTTGGAACCCACGCCG -> AGTTTGGAACCCACGCCGC
ACCGGTGGCCCTCGCAGAT -> CCGGTGGCCCTCGCAGATG
TACACCGGCAATCATCCGC -> ACACCGGCAATCATCCGCC
TCAACTACCGCAACTGCGG -> CAACTACCGCAACTGCGGT
TTTCGACAGATTCGACCGC -> TTCGACAGATTCGACCGCA
TGTTAAATCATGTCCTTAG -> GTTAAATCATGTCCTTAGT
TGGATATACTTGGGTGCAT -> GGATATACTTGGGTGCATT
AAATACTGAGGGTATTTAA -> AATACTGAGGGTATTTAAA
ACGCAGCAACATAACCGGT -> CGCAGCAACATAACCGGTC
TGCGTATTCATATCGTACG -> GCGTATTCATATCGTACGC
TGAAGTATAGAGCGTTAGC -> GAAGTATAGAGCGTTAGCC
CTCTATGTAAACCGACTCC -> TCTATGTAAACCGACTCCC
TGAGGTTGGCGATAAACAG -> GAGGTTGGCGATAAACAGG
CTGCCTCTGCCACCCGGCA -> TGCCTCTGCCACCCGGCAC
CCGAGGCATCCTTAGAGGT -> CGAGGCATCCTTAGAGGTA
ATCACTGGGAACTGTACTA -> TCACTGGGAACTGTACTAT
TATGACACGCAGAACGCAG -> ATGACACGCAGAACGCAGC
CAGCAACATGACCTGCGGG -> AGCAACATGACCTGCGGGC
CCAGAACCATAAAAGGAAA -> CAGAACCATAAAAGGAAAA
GGAATGTAATATACAGAGG -> GAATGTAATATACAGAGGT
TGTCGCGCTTGTACGTGGT -> GTCGCGCTTGTACGTGGTC
TTCTTTTTATTCCATAAAC -> TCTTTTTATTCCATAAACA
TATAGGTACTGCAGTGTCG -> ATAGGTACTGCAGTGTCGG
GTTAGCGGAAGCGTGGAAT -> TTAGCGGAAGCGTGGAATG
AATAATGTAGCGTGTAGCA -> ATAATGTAGCGTGTAGCAG
GTTCGCAAGACGGTGCTTC -> TTCGCAAGACGGTGCTTCC
TGTACCAACAACAGTTAGC -> GTACCAACAACAGTTAGCG
CTGTGCCCCCGTGCACGAA -> TGTGCCCCCGTGCACGAAT
TGGCCCTCGCAGATGAGGT -> GGCCCTCGCAGATGAGGTG
TAGGTACTGCAGTGTCGGT -> AGGTACTGCAGTGTCGGTC
CGCCGAAATGCCGCACCAG -> GCCGAAATGCCGCACCAGA
TACAGCCTCTTGCAATCCA -> ACAGCCTCTTGCAATCCAC
ATCCTTAGAGGTATTCAGA -> TCCTTAGAGGTATTCAGAA
CTGAGGGTATTTAAAGTAT -> TGAGGGTATTTAAAGTATG
GGAGCACTGTTCCCTTCGA -> GAGCACTGTTCCCTTCGAC
GGGATACTGGTGCCTCTTT -> GGATACTGGTGCCTCTTTA
CCCGTGCGTGTCGTATAGG -> CCGTGCGTGTCGTATAGGT
TTTTCTGTACCAACAACAG -> TTTCTGTACCAACAACAGT
TTCTCATGAATGTGCCCTG -> TCTCATGAATGTGCCCTGG
CTCCTTAGAGGTATTCAGA -> TCCTTAGAGGTATTCAGAC
AGTTAGAATAATGTAGCGT -> GTTAGAATAATGTAGCGTG
ACTTAGGAATGTCCCGTTC -> CTTAGGAATGTCCCGTTCT
GACATCGTCTTACATATCG -> ACATCGTCTTACATATCGT
ATGTAAACCGACTCCCGCA -> TGTAAACCGACTCCCGCAT
GCTTGTACGTGGTCCTTAG -> CTTGTACGTGGTCCTTAGA
GAAGCGTGGAATGTAATAT -> AAGCGTGGAATGTAATATA
TAGTCATTCGACATCGTCT -> AGTCATTCGACATCGTCTT
AAAACCGCGAGGAAAATGT -> AAACCGCGAGGAAAATGTT
CATTGGCTGTGCTTGACCT -> ATTGGCTGTGCTTGACCTT
GCAGATGAGGTGCCGGATG -> CAGATGAGGTGCCGGATGC
CAAAACAGGTTGCGGAAAA -> AAAACAGGTTGCGGAAAAA
CCGAAATGCCGCACCAGAA -> CGAAATGCCGCACCAGAAC
AACTAAAACCGCGAGGAAA -> ACTAAAACCGCGAGGAAAA
ACCCTCCAGTATTGTCAGA -> CCCTCCAGTATTGTCAGAA
GAGGTAGGGCGCTAGTCTA -> AGGTAGGGCGCTAGTCTAC
ATGCACGTGACAAACAGGT -> TGCACGTGACAAACAGGTT
AGCTAAGGTCCTCAGTACA -> GCTAAGGTCCTCAGTACAA
CTCGCACTAACCCCCAGCC -> TCGCACTAACCCCCAGCCG
TAAAGTGGCCCGTGCGTGT -> AAAGTGGCCCGTGCGTGTC
CTTTACAATAGTTAGAATA -> TTTACAATAGTTAGAATAA
CGATAATGTTTCTTTCGAC -> GATAATGTTTCTTTCGACT
GTATTCATATCGTACGCTG -> TATTCATATCGTACGCTGT
GCTATGACACGCAGAACGC -> CTATGACACGCAGAACGCA
CAACGTGCCCTCTATGTAA -> AACGTGCCCTCTATGTAAA
TGGAATGTAATATACAGAG -> GGAATGTAATATACAGAGG
TTATTGTTCCGTTTTCAAG -> TATTGTTCCGTTTTCAAGG
TGACCTTCTGTGCCCCCGT -> GACCTTCTGTGCCCCCGTG
GATGTTGGTAGAAGTCGCC -> ATGTTGGTAGAAGTCGCCT
GCATAGACGTTAACAATTT -> CATAGACGTTAACAATTTA
GAGGCATCCTTAGAGGTAT -> AGGCATCCTTAGAGGTATT
ATTGTTCGCAAGACGGTGC -> TTGTTCGCAAGACGGTGCT
TGAGACGTTCTTTTTATTC -> GAGACGTTCTTTTTATTCC
CACCCGGCACTATGATTCC -> ACCCGGCACTATGATTCCA
CCGGCGGGTATTTCAGAAT -> CGGCGGGTATTTCAGAATA
GGCCCTCGCAGATGAGGTG -> GCCCTCGCAGATGAGGTGC
ATAGAGCGTTAGCCCTTCA -> TAGAGCGTTAGCCCTTCAA
GGCCCAGCCCTAATAGTAG -> GCCCAGCCCTAATAGTAGT
CGGATGCGAGAGTGCACCT -> GGATGCGAGAGTGCACCTC
AGGTATTCAGATGGGGGTG -> GGTATTCAGATGGGGGTGC
ACTGTACTATCTGAACTTC -> CTGTACTATCTGAACTTCA
GCCTCTTTACAATAGTTAG -> CCTCTTTACAATAGTTAGA
TGCGCCGAGTGGCGATCGG -> GCGCCGAGTGGCGATCGGT
ACGGTGCTTCCTTAGAGGT -> CGGTGCTTCCTTAGAGGTA
TCCCGCATAGACGTTAACA -> CCCGCATAGACGTTAACAA
GCGGGTATTTCAGAATAAA -> CGGGTATTTCAGAATAAAC
CGTTTCAGTGCAAGGTAAT -> GTTTCAGTGCAAGGTAATA
GTGTCGGTCTCGAGGATGC -> TGTCGGTCTCGAGGATGCG
CGACAGATTCGACCGCATC -> GACAGATTCGACCGCATCT
GAGGAAAATGTTAAATCAT -> AGGAAAATGTTAAATCATG
AGTTTGGAACCCACGCCGC -> GTTTGGAACCCACGCCGCA
ATGAGGTGCCGGATGCGAG -> TGAGGTGCCGGATGCGAGA
CTAAAACCGCGAGGAAAAT -> TAAAACCGCGAGGAAAATG
GTCTCGAGGATGCGCGTGA -> TCTCGAGGATGCGCGTGAC
CACCATTCGATTGGACGGA -> ACCATTCGATTGGACGGAA
ACAGGGGCCCCCGGATGAT -> CAGGGGCCCCCGGATGATA
AATAGTTAGAATAATGTAG -> ATAGTTAGAATAATGTAGC
CCGTGCGTGTCGTATAGGT -> CGTGCGTGTCGTATAGGTA
TTTCTGTACCAACAACAGT -> TTCTGTACCAACAACAGTT
CCATGTCTATCATAGCTAC -> CATGTCTATCATAGCTACA
ATGTAATATACAGAGGTTA -> TGTAATATACAGAGGTTAA
TACATGAGCCGTTTCAGTG -> ACATGAGCCGTTTCAGTGC
GGTTGGGGGCCGTAGCAAG -> GTTGGGGGCCGTAGCAAGC
CGTGGTCCTTAGAGGTATT -> GTGGTCCTTAGAGGTATTC
CGGGCTCACACGTTCGAGA -> GGGCTCACACGTTCGAGAT
TAGAAGCCAAAACAGGTTG -> AGAAGCCAAAACAGGTTGC
CATTTGCCTTGAAAAATAA -> ATTTGCCTTGAAAAATAAG
CAGGTTAAAGGGTAGGTAC -> AGGTTAAAGGGTAGGTACG
TGACACGCAGAACGCAGCA -> GACACGCAGAACGCAGCAA
TACGCTGTACTCGTGTCGC -> ACGCTGTACTCGTGTCGCG
TGATATGGGCCTAACAGTT -> GATATGGGCCTAACAGTTC
ATTACATCGTTTAACATAC -> TTACATCGTTTAACATACG
AATAAGACTCGCACTAACC -> ATAAGACTCGCACTAACCC
TATATGCGAGAGACAATTC -> ATATGCGAGAGACAATTCT
CCTCAACTACCGCAACTGC -> CTCAACTACCGCAACTGCG
TTGTCGTTAGTTTATTGGA -> TGTCGTTAGTTTATTGGAT
AGTTCCGGTTGGGTGCCCC -> GTTCCGGTTGGGTGCCCCG
TTGGATATACTTGGGTGCA -> TGGATATACTTGGGTGCAT
GTATGGGACCGCTCTCAGC -> TATGGGACCGCTCTCAGCT
TGTACTCGTGTCGCGCTTG -> GTACTCGTGTCGCGCTTGT
ATAAACAGATTTACAGCAA -> TAAACAGATTTACAGCAAC
CTGTACCAACAACAGTTAG -> TGTACCAACAACAGTTAGC
TATGGGACCGCTCTCAGCT -> ATGGGACCGCTCTCAGCTG
CTCGTGTCGCGCTTGTACG -> TCGTGTCGCGCTTGTACGT
TTAGACGCCCTAATAGTAG -> TAGACGCCCTAATAGTAGT
GAGGTATTCAGATGGGGGT -> AGGTATTCAGATGGGGGTG
CGTTCTTTTTATTCCATAA -> GTTCTTTTTATTCCATAAA
CAGAACCATAAAAGGAAAA -> AGAACCATAAAAGGAAAAC
TTGGACTATATACGCCGAA -> TGGACTATATACGCCGAAA
TACATATCGTAAAGTGGCC -> ACATATCGTAAAGTGGCCC
CCCTAGCATCCGAGGCATC -> CCTAGCATCCGAGGCATCC
CCAGCCCTAATAGTAGTTC -> CAGCCCTAATAGTAGTTCC
ATTCGACCGCATCTTTTTT -> TTCGACCGCATCTTTTTTA
GTTATTGTCGTTAGTTTAT -> TTATTGTCGTTAGTTTATT
GTAGTTCCGGCGGGTATTT -> TAGTTCCGGCGGGTATTTC
CTTCAAACCCTTAATTTTC -> TTCAAACCCTTAATTTTCT
CTATGACACGCAGAACGCA -> TATGACACGCAGAACGCAG
ATAGTCATTCGACATCGTC -> TAGTCATTCGACATCGTCT
AGTGGCCCGTGCGTGTCGT -> GTGGCCCGTGCGTGTCGTA
CCCTTCAAACCCTTAATTT -> CCTTCAAACCCTTAATTTT
GCGCTTGTACGTGGTCCTT -> CGCTTGTACGTGGTCCTTA
AGTTCCGGCCTGGGCGCAG -> GTTCCGGCCTGGGCGCAGC
ATGGGGGTGCGAGCCCTAA -> TGGGGGTGCGAGCCCTAAT
GACCGCATCTTTTTTATGC -> ACCGCATCTTTTTTATGCG
TCTCATGAATGTGCCCTGG -> CTCATGAATGTGCCCTGGC
TTTAAGCATGAAGTATAGA -> TTAAGCATGAAGTATAGAG
CTTGCAATCCACTTTACCG -> TTGCAATCCACTTTACCGT
TAAGACAAACCGCAGCATA -> AAGACAAACCGCAGCATAC
CCGGTTTCACAGGGGCCCC -> CGGTTTCACAGGGGCCCCC
TCTATCATAGCTACATTAT -> CTATCATAGCTACATTATT
AGATGCACTAGCCCAGCGT -> GATGCACTAGCCCAGCGTT
CGCGCTTGTACGTGGTCCT -> GCGCTTGTACGTGGTCCTT
CGCCGCATCATAGAGTTAT -> GCCGCATCATAGAGTTATT
TGTCCCGTTCTCATGAATG -> GTCCCGTTCTCATGAATGT
AATAGTAGTTCCGGCGGGT -> ATAGTAGTTCCGGCGGGTA
GCCGCATCATAGAGTTATT -> CCGCATCATAGAGTTATTG
GCCTGGGCGCAGCTAAGGT -> CCTGGGCGCAGCTAAGGTC
CTGTTCCCTTCGACGGTGT -> TGTTCCCTTCGACGGTGTG
GCATAGGCGTAGGTGAGGC -> CATAGGCGTAGGTGAGGCA
CACCGGCAATCATCCGCCG -> ACCGGCAATCATCCGCCGC
AAACCATTTTGATGAATTA -> AACCATTTTGATGAATTAC
ACACTAACCCTCCAGTATT -> CACTAACCCTCCAGTATTG
TGCCCAAAGCTTGTTGTAA -> GCCCAAAGCTTGTTGTAAA
GTCTACGCTGTTAACACTT -> TCTACGCTGTTAACACTTA
CATAGACGTTAACAATTTA -> ATAGACGTTAACAATTTAT
CTGATGTATAGTCATTCGA -> TGATGTATAGTCATTCGAC
GATGAATTACATCGTTTAA -> ATGAATTACATCGTTTAAC
AGACGTTAACAATTTATAT -> GACGTTAACAATTTATATG
TCGAGATGCACTAGCCCAG -> CGAGATGCACTAGCCCAGC
ATAAGCGGGTCTAGGAACA -> TAAGCGGGTCTAGGAACAG
TGTAAAAGTTTAAGCATGA -> GTAAAAGTTTAAGCATGAA
GTATTCAGATGGGGGTGCG -> TATTCAGATGGGGGTGCGA
CCTGCCCAAAGCTTGTTGT -> CTGCCCAAAGCTTGTTGTA
CAATAGTTAGAATAATGTA -> AATAGTTAGAATAATGTAG
CTGGTGAACATAGACTATA -> TGGTGAACATAGACTATAT
CTTGCATAGGCGTAGGTGA -> TTGCATAGGCGTAGGTGAG
ACTGAGGTTGGCGATAAAC -> CTGAGGTTGGCGATAAACA
TGGAGGAGCACTGTTCCCT -> GGAGGAGCACTGTTCCCTT
CCTCGCAGATGAGGTGCCG -> CTCGCAGATGAGGTGCCGG
CACATTGGCTGTGCTTGAC -> ACATTGGCTGTGCTTGACC
CGCAGAACGCAGCAACATA -> GCAGAACGCAGCAACATAA
ACTCGTGTCGCGCTTGTAC -> CTCGTGTCGCGCTTGTACG
GCAGCATACGCAATGCGTA -> CAGCATACGCAATGCGTAT
AGAGAAACTTAGACGCCCT -> GAGAAACTTAGACGCCCTA
ATTGTCAGAAATAGAAGCC -> TTGTCAGAAATAGAAGCCA
ACTACACCGGCAATCATCC -> CTACACCGGCAATCATCCG
AGCGGAAGCGTGGAATGTA -> GCGGAAGCGTGGAATGTAA
TACTGAGGGTATTTAAAGT -> ACTGAGGGTATTTAAAGTA
AACCACTCCGGGCTGTGCG -> ACCACTCCGGGCTGTGCGA
ACAAACAGGTTGGGGGCCG -> CAAACAGGTTGGGGGCCGT
GAAAAAAACCTCAACTACC -> AAAAAAACCTCAACTACCG
GTCGTGAGTCGCCCTAATA -> TCGTGAGTCGCCCTAATAG
AAGGGTAGGTACGGCCTGG -> AGGGTAGGTACGGCCTGGG
ACGTGGTCCTTAGAGGTAT -> CGTGGTCCTTAGAGGTATT
AGTAGTTCCGGTTTCACAG -> GTAGTTCCGGTTTCACAGG
TGATACGCCTGCCCAAAGC -> GATACGCCTGCCCAAAGCT
GCCCTCTATGTAAACCGAC -> CCCTCTATGTAAACCGACT
ACTGGTGCCTCTTTACAAT -> CTGGTGCCTCTTTACAATA
ATATACGCCGAAATGCCGC -> TATACGCCGAAATGCCGCA
ATGCGGTAACTGCGCAGCA -> TGCGGTAACTGCGCAGCAA
CTATGATTCCAAATTGTTC -> TATGATTCCAAATTGTTCG
TATACAGAGGTTAAGTGTC -> ATACAGAGGTTAAGTGTCA
TCAACGTGCCCTCTATGTA -> CAACGTGCCCTCTATGTAA
GCGAGGAAAATGTTAAATC -> CGAGGAAAATGTTAAATCA
AGAATAATGTAGCGTGTAG -> GAATAATGTAGCGTGTAGC
TACCAACAACAGTTAGCGG -> ACCAACAACAGTTAGCGGA
CTTGTTGTAAAAGTTTAAG -> TTGTTGTAAAAGTTTAAGC
GGCAATCATCCGCCGCATC -> GCAATCATCCGCCGCATCA
AAACTTAGACGCCCTAATA -> AACTTAGACGCCCTAATAG
GTGATACGCCTGCCCAAAG -> TGATACGCCTGCCCAAAGC
CAAGGTAATAAGTGCCAGT -> AAGGTAATAAGTGCCAGTT
CATGAATGTGCCCTGGCTT -> ATGAATGTGCCCTGGCTTT
AATGTTTCTTTCGACTACT -> ATGTTTCTTTCGACTACTA
GCTTCCTTAGAGGTATTCA -> CTTCCTTAGAGGTATTCAG
GTGGAATGTAATATACAGA -> TGGAATGTAATATACAGAG
ATGGGGAGTTTGGACTATA -> TGGGGAGTTTGGACTATAT
TATTGTCGTTAGTTTATTG -> ATTGTCGTTAGTTTATTGG
ATACAGAGGTTAAGTGTCA -> TACAGAGGTTAAGTGTCAA
TAATAGTAGTTCCGGCGGG -> AATAGTAGTTCCGGCGGGT
ATGACACGCAGAACGCAGC -> TGACACGCAGAACGCAGCA
AAGCATGAAGTATAGAGCG -> AGCATGAAGTATAGAGCGT
TGTCGTATAGGTACTGCAG -> GTCGTATAGGTACTGCAGT
GGGCCGTAGCAAGCATAGC -> GGCCGTAGCAAGCATAGCT
CTTAGAGGTATTCAGAAAA -> TTAGAGGTATTCAGAAAAG
GGTGAGGCACACAGGTTAT -> GTGAGGCACACAGGTTATC
TCGTACGCTGTACTCGTGT -> CGTACGCTGTACTCGTGTC
ACAGAGGTTAAGTGTCAAC -> CAGAGGTTAAGTGTCAACT
TAGTTCCGGCCTGGGCGCA -> AGTTCCGGCCTGGGCGCAG
TTAGCGGAAGCGTGGAATG -> TAGCGGAAGCGTGGAATGT
AGCCTCTTGCAATCCACTT -> GCCTCTTGCAATCCACTTT
CATAGCTACATTATTCGCT -> ATAGCTACATTATTCGCTG
TGTGCCCCCGTGCACGAAT -> GTGCCCCCGTGCACGAATC
GCCCCCGTGCACGAATCCG -> CCCCCGTGCACGAATCCGA
ACTACCGCAACTGCGGTGA -> CTACCGCAACTGCGGTGAG
TGTGCTTGACCTTCTGTGC -> GTGCTTGACCTTCTGTGCC
AGCATGAAGTATAGAGCGT -> GCATGAAGTATAGAGCGTT
TGACCTGCGGGCTCACACG -> GACCTGCGGGCTCACACGT
TCTGCCACCCGGCACTATG -> CTGCCACCCGGCACTATGA
GGTCTCGAGGATGCGCGTG -> GTCTCGAGGATGCGCGTGA
CATAGCTGTAGTAAGCTAT -> ATAGCTGTAGTAAGCTATG
AGTTTAGAACTGATGTATA -> GTTTAGAACTGATGTATAG
ATACGCCGAAATGCCGCAC -> TACGCCGAAATGCCGCACC
GAACTGTACTATCTGAACT -> AACTGTACTATCTGAACTT
TCTCGATCAGATGCACGTG -> CTCGATCAGATGCACGTGA
TTCTTTCCTCCTTAGAGGT -> TCTTTCCTCCTTAGAGGTA
GCATCCTTAGAGGTATTCA -> CATCCTTAGAGGTATTCAG
AGACGTTCTTTTTATTCCA -> GACGTTCTTTTTATTCCAT
ATATGCGAGAGACAATTCT -> TATGCGAGAGACAATTCTT
ATACGCCTTGCTCGGGACT -> TACGCCTTGCTCGGGACTT
CGCAATGCGTATTCATATC -> GCAATGCGTATTCATATCG
TTGATGAATTACATCGTTT -> TGATGAATTACATCGTTTA
CAGGTTGGGGGCCGTAGCA -> AGGTTGGGGGCCGTAGCAA
CACTTAGGAATGTCCCGTT -> ACTTAGGAATGTCCCGTTC
AGGCGATGTGACTCTTCTC -> GGCGATGTGACTCTTCTCC
GAGGTTAAGTGTCAACTGC -> AGGTTAAGTGTCAACTGCG
TGTCAGTCGAGTGGTTAAA -> GTCAGTCGAGTGGTTAAAC
GGGGCCGTAGCAAGCATAG -> GGGCCGTAGCAAGCATAGC
TTCCGGTTTCACAGGGGCC -> TCCGGTTTCACAGGGGCCC
CGCCGCAGTTTAGAACTGA -> GCCGCAGTTTAGAACTGAT
CATGTCTATCATAGCTACA -> ATGTCTATCATAGCTACAT
GTTAAACTAGACTTACAGC -> TTAAACTAGACTTACAGCC
CCATTTTGATGAATTACAT -> CATTTTGATGAATTACATC
TCAGAAATAGAAGCCAAAA -> CAGAAATAGAAGCCAAAAC
GTGACGCCCTATCAAATAC -> TGACGCCCTATCAAATACT
AGGAAAACCAACACTAACC -> GGAAAACCAACACTAACCC
TTTGTAATTAACACCATTC -> TTGTAATTAACACCATTCG
CCTTAGTTGTCGATGTGAT -> CTTAGTTGTCGATGTGATG
TTTATTCCATAAACAGATT -> TTATTCCATAAACAGATTT
CGCAGATGAGGTGCCGGAT -> GCAGATGAGGTGCCGGATG
CTCGATCAGATGCACGTGA -> TCGATCAGATGCACGTGAC
TGATTCCAAATTGTTCGCA -> GATTCCAAATTGTTCGCAA
TGTAGCAGACTTATTTCGA -> GTAGCAGACTTATTTCGAC
ACTGTCAGTCGAGTGGTTA -> CTGTCAGTCGAGTGGTTAA
CCGGCACTATGATTCCAAA -> CGGCACTATGATTCCAAAT
TACCGCAACTGCGGTGAGT -> ACCGCAACTGCGGTGAGTT
GTCACATTGGCTGTGCTTG -> TCACATTGGCTGTGCTTGA
GATCAGATGCACGTGACAA -> ATCAGATGCACGTGACAAA
TGGTAGAAGTCGCCTGCAG -> GGTAGAAGTCGCCTGCAGA
AGTGCACCTCCAACCTGCA -> GTGCACCTCCAACCTGCAG
CGGGACTTAGTTTGGAACC -> GGGACTTAGTTTGGAACCC
TAGAGGTATTCAGATGGGG -> AGAGGTATTCAGATGGGGG
AGCATACGCAATGCGTATT -> GCATACGCAATGCGTATTC
AGTACAATTTTTAGCCCAT -> GTACAATTTTTAGCCCATT
GGCCTGGGCGCAGCTAAGG -> GCCTGGGCGCAGCTAAGGT
CCCGTGCACGAATCCGAGA -> CCGTGCACGAATCCGAGAC
AGGCGTAGGTGAGGCACAC -> GGCGTAGGTGAGGCACACA
TCTTTCCTCCTTAGAGGTA -> CTTTCCTCCTTAGAGGTAT
CAAATTGTTCGCAAGACGG -> AAATTGTTCGCAAGACGGT
GTCAACTGAGGTTGGCGAT -> TCAACTGAGGTTGGCGATA
TCGTTTAACATACGCCTTG -> CGTTTAACATACGCCTTGC
TGCCGGATGCGAGAGTGCA -> GCCGGATGCGAGAGTGCAC
CCTCCAGTATTGTCAGAAA -> CTCCAGTATTGTCAGAAAT
TGTACTATCTGAACTTCAC -> GTACTATCTGAACTTCACT
AGGAAAATGTTAAATCATG -> GGAAAATGTTAAATCATGT
AGTCATTCGACATCGTCTT -> GTCATTCGACATCGTCTTA
AATGTAGCGTGTAGCAGAC -> ATGTAGCGTGTAGCAGACT
TCTTGCAATCCACTTTACC -> CTTGCAATCCACTTTACCG
GTTAAGACAAACCGCAGCA -> TTAAGACAAACCGCAGCAT
CTGTAACCATGTCTATCAT -> TGTAACCATGTCTATCATA
GGTCCTTAGAGGTATTCAG -> GTCCTTAGAGGTATTCAGA
TCTCCTTGCATAGGCGTAG -> CTCCTTGCATAGGCGTAGG
CACTAGCCCAGCGTTAAGA -> ACTAGCCCAGCGTTAAGAC
GGTCCTCAGTACAATTTTT -> GTCCTCAGTACAATTTTTA
CAGAGGTTAAGTGTCAACT -> AGAGGTTAAGTGTCAACTG
TTCAGATGGGGGTGCGAGC -> TCAGATGGGGGTGCGAGCC
ATAATGTAGCGTGTAGCAG -> TAATGTAGCGTGTAGCAGA
CCTGCCTCTGCCACCCGGC -> CTGCCTCTGCCACCCGGCA
TTGCTCGGGACTTAGTTTG -> TGCTCGGGACTTAGTTTGG
GGAACTAAAACCGCGAGGA -> GAACTAAAACCGCGAGGAA
GATAAACAGGTTAAAGGGT -> ATAAACAGGTTAAAGGGTA
AATAATGGGGAGTTTGGAC -> ATAATGGGGAGTTTGGACT
GGTATTCAGAAAAGCGGCC -> GTATTCAGAAAAGCGGCCC
GTGCCCTGGCTTTTCTCGA -> TGCCCTGGCTTTTCTCGAT
GGAATGTCCCGTTCTCATG -> GAATGTCCCGTTCTCATGA
TATGGGCCTAACAGTTCTG -> ATGGGCCTAACAGTTCTGG
CTTAGAGGTATTCAGATGG -> TTAGAGGTATTCAGATGGG
CTGTAGTAAGCTATGACAC -> TGTAGTAAGCTATGACACG
AGACGGTGCTTCCTTAGAG -> GACGGTGCTTCCTTAGAGG
GCTCTCAGCTGCCGAAACG -> CTCTCAGCTGCCGAAACGA
ACCTGCGGGCTCACACGTT -> CCTGCGGGCTCACACGTTC
TAGGTGAGGCACACAGGTT -> AGGTGAGGCACACAGGTTA
CCGAGCGACCGGTGGCCCT -> CGAGCGACCGGTGGCCCTC
CATACGCCTTGCTCGGGAC -> ATACGCCTTGCTCGGGACT
TTTGATGAATTACATCGTT -> TTGATGAATTACATCGTTT
GCGGGCTCACACGTTCGAG -> CGGGCTCACACGTTCGAGA
TGTTAACACTTAGGAATGT -> GTTAACACTTAGGAATGTC
GTGCGAGCCCTAATAGTAG -> TGCGAGCCCTAATAGTAGT
GCAATCCACTTTACCGTGT -> CAATCCACTTTACCGTGTG
CACTTTACCGTGTGAAACC -> ACTTTACCGTGTGAAACCG
GAAATGCCGCACCAGAACC -> AAATGCCGCACCAGAACCA
AATGTAATATACAGAGGTT -> ATGTAATATACAGAGGTTA
GTTTCACAGGGGCCCCCGG -> TTTCACAGGGGCCCCCGGA
ACTTATTTCGACAGATTCG -> CTTATTTCGACAGATTCGA
GTTAAGTGTCAACTGCGCC -> TTAAGTGTCAACTGCGCCT
AATTAACACCATTCGATTG -> ATTAACACCATTCGATTGG
GAATGTCCCGTTCTCATGA -> AATGTCCCGTTCTCATGAA
CTGCAGAATAATGGGGAGT -> TGCAGAATAATGGGGAGTT
TCGCACTAACCCCCAGCCG -> CGCACTAACCCCCAGCCGG
CGTTAGTTTATTGGATATA -> GTTAGTTTATTGGATATAC
CAGGGGCCCCCGGATGATA -> AGGGGCCCCCGGATGATAT
TGTCGTTAGTTTATTGGAT -> GTCGTTAGTTTATTGGATA
TCTATGTAAACCGACTCCC -> CTATGTAAACCGACTCCCG
GGTGCCCCGAGCGACCGGT -> GTGCCCCGAGCGACCGGTG
TATTCATATCGTACGCTGT -> ATTCATATCGTACGCTGTA
ACTAGACTTACAGCCTCTT -> CTAGACTTACAGCCTCTTG
CAACAGTTAGCGGAAGCGT -> AACAGTTAGCGGAAGCGTG
GGAAAAAAACCTCAACTAC -> GAAAAAAACCTCAACTACC
GGTTAAACTAGACTTACAG -> GTTAAACTAGACTTACAGC
TTTCGACTACTACACCGGC -> TTCGACTACTACACCGGCA
GACTATATACGCCGAAATG -> ACTATATACGCCGAAATGC
CGAGGAAAATGTTAAATCA -> GAGGAAAATGTTAAATCAT
AACCGACTCCCGCATAGAC -> ACCGACTCCCGCATAGACG
GCATCTTTTTTATGCGGTA -> CATCTTTTTTATGCGGTAA
TACGCCTTGCTCGGGACTT -> ACGCCTTGCTCGGGACTTA
GTGATGAGACGTTCTTTTT -> TGATGAGACGTTCTTTTTA
TACATCGTTTAACATACGC -> ACATCGTTTAACATACGCC
TCTACGCTGTTAACACTTA -> CTACGCTGTTAACACTTAG
GTGCCAGTTTGTCACATTG -> TGCCAGTTTGTCACATTGG
TCGATAATGTTTCTTTCGA -> CGATAATGTTTCTTTCGAC
CTTAGAGGTATTCAGACGT -> TTAGAGGTATTCAGACGTC
CATCCGAGGCATCCTTAGA -> ATCCGAGGCATCCTTAGAG
ACGGTGTGTATATAAGCGG -> CGGTGTGTATATAAGCGGG
CGCCTTGCTCGGGACTTAG -> GCCTTGCTCGGGACTTAGT
CATTATTGTTCCGTTTTCA -> ATTATTGTTCCGTTTTCAA
TTGTAATTAACACCATTCG -> TGTAATTAACACCATTCGA
GGCGATAAACAGGTTAAAG -> GCGATAAACAGGTTAAAGG
ATCATAGCTACATTATTCG -> TCATAGCTACATTATTCGC
GCGGAAGCGTGGAATGTAA -> CGGAAGCGTGGAATGTAAT
CTGCCGAAACGAATGTGAT -> TGCCGAAACGAATGTGATA
GATGCGCGTGACGCCCTAT -> ATGCGCGTGACGCCCTATC
CTAATTGACATTTGCCTTG -> TAATTGACATTTGCCTTGA
CAATTCTTTCCTCCTTAGA -> AATTCTTTCCTCCTTAGAG
ACTGTAACCATGTCTATCA -> CTGTAACCATGTCTATCAT
TATTCAGAGAAACTTAGAC -> ATTCAGAGAAACTTAGACG
TAGGTTTTGTAATTAACAC -> AGGTTTTGTAATTAACACC
TCTCGAGGATGCGCGTGAC -> CTCGAGGATGCGCGTGACG
CTCCAACCTGCAGATGTTG -> TCCAACCTGCAGATGTTGG
CGCGTGACGCCCTATCAAA -> GCGTGACGCCCTATCAAAT
AAACCGATTCCCTAGCATC -> AACCGATTCCCTAGCATCC
CTCTTTACAATAGTTAGAA -> TCTTTACAATAGTTAGAAT
ATTTCAGAATAAACCATTT -> TTTCAGAATAAACCATTTT
GATTTACAGCAACATGACC -> ATTTACAGCAACATGACCT
GAGACAATTCTTTCCTCCT -> AGACAATTCTTTCCTCCTT
GCGTATTCATATCGTACGC -> CGTATTCATATCGTACGCT
CTAATAGTAGTTCCGGTTT -> TAATAGTAGTTCCGGTTTC
GTGCGCCGAGTGGCGATCG -> TGCGCCGAGTGGCGATCGG
TGACAAACAGGTTGGGGGC -> GACAAACAGGTTGGGGGCC
TACCGTGTGAAACCGATTC -> ACCGTGTGAAACCGATTCC
AACTTAGACGCCCTAATAG -> ACTTAGACGCCCTAATAGT
ATGCGTATTCATATCGTAC -> TGCGTATTCATATCGTACG
GCAACATAACCGGTCAACG -> CAACATAACCGGTCAACGT
CCGGATGCGAGAGTGCACC -> CGGATGCGAGAGTGCACCT
GGGCGCAGCTAAGGTCCTC -> GGCGCAGCTAAGGTCCTCA
TGCCCCGAGCGACCGGTGG -> GCCCCGAGCGACCGGTGGC
CCGTTTTCAAGGAGGGATA -> CGTTTTCAAGGAGGGATAC
GTCTAGGAACAGACATACA -> TCTAGGAACAGACATACAT
TGTAAACCGACTCCCGCAT -> GTAAACCGACTCCCGCATA
ATGATATGGGCCTAACAGT -> TGATATGGGCCTAACAGTT
GAGATGCACTAGCCCAGCG -> AGATGCACTAGCCCAGCGT
GCGGGTCTAGGAACAGACA -> CGGGTCTAGGAACAGACAT
ACGAATCCGAGACTTACTC -> CGAATCCGAGACTTACTCG
CCAACAACAGTTAGCGGAA -> CAACAACAGTTAGCGGAAG
ATACTGAGGGTATTTAAAG -> TACTGAGGGTATTTAAAGT
TTGGCTGTGCTTGACCTTC -> TGGCTGTGCTTGACCTTCT
CCGTTCTCATGAATGTGCC -> CGTTCTCATGAATGTGCCC
AACCGCGAGGAAAATGTTA -> ACCGCGAGGAAAATGTTAA
TCAGTGCAAGGTAATAAGT -> CAGTGCAAGGTAATAAGTG
GGGTATTTAAAGTATGGGA -> GGTATTTAAAGTATGGGAC
TGTGCGACTTAGGCGATGT -> GTGCGACTTAGGCGATGTG
CTCGGGACTTAGTTTGGAA -> TCGGGACTTAGTTTGGAAC
AAGGAGGGATACTGGTGCC -> AGGAGGGATACTGGTGCCT
TTATGCGGTAACTGCGCAG -> TATGCGGTAACTGCGCAGC
TGTCTATCATAGCTACATT -> GTCTATCATAGCTACATTA
TGCTAGGTTTTGTAATTAA -> GCTAGGTTTTGTAATTAAC
CCTTGCTCGGGACTTAGTT -> CTTGCTCGGGACTTAGTTT
GCCTGCCCAAAGCTTGTTG -> CCTGCCCAAAGCTTGTTGT
GCACGAATCCGAGACTTAC -> CACGAATCCGAGACTTACT
TGGGTGCATTTTGGATGCC -> GGGTGCATTTTGGATGCCT
GCCGTAGCAAGCATAGCTG -> CCGTAGCAAGCATAGCTGT
CCGGTGGCCCTCGCAGATG -> CGGTGGCCCTCGCAGATGA
CGTAGGTGAGGCACACAGG -> GTAGGTGAGGCACACAGGT
ATGAATGTGCCCTGGCTTT -> TGAATGTGCCCTGGCTTTT
AGGTGGTACCTCACTGTAA -> GGTGGTACCTCACTGTAAC
AGACTTACAGCCTCTTGCA -> GACTTACAGCCTCTTGCAA
CCGAAACGAATGTGATACG -> CGAAACGAATGTGATACGC
GTGAGTCGCCCTAATAGTA -> TGAGTCGCCCTAATAGTAG
GAAACGAATGTGATACGCC -> AAACGAATGTGATACGCCT
GTAGGGCGCTAGTCTACGC -> TAGGGCGCTAGTCTACGCT
GCTGTACTCGTGTCGCGCT -> CTGTACTCGTGTCGCGCTT
TGCAGAATAATGGGGAGTT -> GCAGAATAATGGGGAGTTT
TTGTTGTAAAAGTTTAAGC -> TGTTGTAAAAGTTTAAGCA
TTTACCGTGTGAAACCGAT -> TTACCGTGTGAAACCGATT
CATAAACAGATTTACAGCA -> ATAAACAGATTTACAGCAA
GCAGATGTTGGTAGAAGTC -> CAGATGTTGGTAGAAGTCG
CAAGCATAGCTGTAGTAAG -> AAGCATAGCTGTAGTAAGC
GGGCTGTGCGACTTAGGCG -> GGCTGTGCGACTTAGGCGA
CCGGGCTGTGCGACTTAGG -> CGGGCTGTGCGACTTAGGC
CTGCGGTGAGTTTCGTCAA -> TGCGGTGAGTTTCGTCAAC
CGGCACTATGATTCCAAAT -> GGCACTATGATTCCAAATT
AACCGGTCAACGTGCCCTC -> ACCGGTCAACGTGCCCTCT
GCGACTTAGGCGATGTGAC -> CGACTTAGGCGATGTGACT
TGGTGAACATAGACTATAT -> GGTGAACATAGACTATATC
TCCTCCTTAGAGGTATTCA -> CCTCCTTAGAGGTATTCAG
CGCAGCAACCACTCCGGGC -> GCAGCAACCACTCCGGGCT
ATCGTAAAGTGGCCCGTGC -> TCGTAAAGTGGCCCGTGCG
CCCCGAGCGACCGGTGGCC -> CCCGAGCGACCGGTGGCCC
GGTTAGCTAATTGACATTT -> GTTAGCTAATTGACATTTG
CAGAATAATGGGGAGTTTG -> AGAATAATGGGGAGTTTGG
TCCTCAGTACAATTTTTAG -> CCTCAGTACAATTTTTAGC
AGTTTGTCACATTGGCTGT -> GTTTGTCACATTGGCTGTG
TAATTGACATTTGCCTTGA -> AATTGACATTTGCCTTGAA
TTCTTTCGACTACTACACC -> TCTTTCGACTACTACACCG
TCGCTGGTGAACATAGACT -> CGCTGGTGAACATAGACTA